~~~~~b~b~bbbb~b~~b~~~~bbb~bbb~b~~bb~~bb~~b~b~~~~b~~~bb~~~~~~bbb~~~~~~~b~~b~~~~b~~~~b~~~~~b~~~~~~b~~b~
b~b~b~bb~~bb~b~~~~b~b~~b~~b~b~~~b~~b~b~~~~~~~bb~~b~~~~bb~~b~~~~~~~~b~~~~~~~~~~bb~~~~~bbb~~~b~~~~~~~~~
~~~~b~~b~~~bb~bb~~~b~~~bb~b~~~~~~~b~~~b~b~bb~~~~~~b~~~b~b~b~b~~~b~bbbb~~b~~~~~b~~bb~~~~~~~~~~b~~b~b~~
b~b~~~~~~~~~~bb~~~~~bb~~~~~b~~~~~~b~b~b~b~~b~~bb~bb~b~~bbb~b~~b~~b~~bb~~~bb~~b~~~bb~~~~~~~~~b~~~~~~~~
~~b~~~~~~~~~~~~~~~~~~~b~~b~b~~~~~~~~~~b~~~b~bbb~b~~~~~~~~b~~~~~~b~b~~~b~~~~b~~b~b~b~~~~~bbbb~~~bb~~~b
b~~b~b~b~~~~~b~~~b~~~~~~~~~~~~~~~~~~~~b~bbb~~b~~~~~~~~~~bb~b~b~~b~~b~~~~bb~~~~~b~~~b~~b~~bb~~~~~~~b~~
~~~~~b~bb~~~~~~bbb~~b~~bb~bb~~b~~bb~~~~bb~~b~~~~bb~~~b~~b~~~~~~b~b~b~~bbbb~~b~~bb~~~~~b~bbb~~~b~~~~b~
~b~b~~b~~~~~b~b~~~~~~b~b~~b~b~~b~~~bb~~~~b~~~~~~b~~~b~b~~~~~b~~~~~~~~~~~~~~bb~~~~b~~b~~~bb~~~~~b~~~~~
~b~b~~~~b~~bbbbbb~~~b~b~~~bb~b~~bb~~b~~~b~b~~~b~~~~~~~~b~~b~~bb~~~b~~~~bb~~~b~~~~b~~b~~~~~~b~~bbbb~bb
~~~bbb~~~~~~~b~~~~~b~~~~~~~b~~~~bb~~~bb~~~bb~bb~~~bb~~~~~~b~b~~~b~~b~~b~~~~~bbb~~~b~~~~~~~~bbb~~~~~~~
~b~~~~~~~bbb~b~b~~~~b~~~~~~~~~~b~~~~b~~~bb~~~~~~~b~~b~b~~~~~b~~~~~~b~~bbb~b~~~~~~~~bb~~b~~~~~bb~~b~~~
bb~~b~~~~~b~~b~~~~b~~~~~~~b~~~~~~~~b~~b~~b~b~~b~~~~b~b~~~~~b~~~~~~~~b~b~~~b~~bb~b~~b~~~~bb~~~~~~~~~b~
~b~~~~~~~~~~~~~~~~~b~b~~bb~b~~~~~b~b~b~~~~~b~~~b~b~~b~b~bb~bbb~b~~b~~~~b~bb~~bb~~~~bb~bb~bb~~b~~~~~b~
~bb~~~~b~bb~~~~~~b~~~~b~b~~~~~~~b~~~~bbb~bbb~b~~~b~b~b~~~~b~bbb~~~~bbb~~~bb~~~~~~~~~~~~~b~~~~~~b~~~bb
~~~b~~~~~~~~b~~~b~~~~~~b~~b~b~~~~~~~~~~~bb~~b~~~~~~~~~~~~~~~~~bb~~~~b~bb~b~~~~~~~b~~~~~~b~b~b~b~bb~~~
b~~~b~~~~~~~~~~~b~~~bb~~~~~~b~b~bb~~~~~b~~~b~~~bbb~~b~~~~~~~bb~~~~~b~~~~~~~~b~~~~~bb~b~b~~~~b~~~~~b~b
~~~~b~~~b~~~~~~~~~b~bbb~~b~bb~b~~~~~~bbb~b~~b~~~bb~~~~~~~~~~b~b~~b~~b~~bb~~b~~~~bb~~~~~~~b~b~b~~bb~~b
~~bb~b~~b~~~~~bbb~~b~~b~~~~b~bbbb~bb~~b~~~b~~~b~~b~~bb~~b~~~b~b~~~~b~~~~~~~bb~~b~b~b~~bb~~~~~~~b~~bb~
~b~~~~~b~b~~b~~~b~~bb~~~~b~~~b~bb~G~b~~~bb~~~~b~~b~b~~~bb~b~~b~~~bbb~bb~~~~~~~~~~b~~~~~b~~~~b~~bb~b~~
~bb~~~~~bb~~b~~~~b~~~~~~~~~~~~~~~~~~~~~bb~~~b~~bb~~b~b~~b~bb~~~b~~b~b~~~~bb~~~~~~~b~~~~~~bb~bb~~~~b~b
~bbb~bbb~~~b~~b~~~~b~~~~bb~~~~~~b~b~b~~~~~~b~b~~~~b~~~~bb~bb~b~~~~~b~~~~~~b~~bb~~~~~~~~~~bb~~~b~~~~b~
~~b~~~bb~bbbb~~b~~bb~~bb~~~~~~~~~~~b~~~~~~b~~~~~~~~b~~bbb~~~b~bbb~~b~b~bbb~~b~b~~bb~~b~~bb~~~b~~~~~~~
~~~~~~~~~~~~~~bb~~~~~b~b~b~b~~~~b~bbb~b~~~~~bbb~~~~~~~~b~b~~~b~~~b~~~bb~b~b~~~bbb~~~~~~b~~~b~~~~~~b~~
~b~~~b~~~~b~~~b~b~~~~~~~~~b~~~~~bb~b~b~~b~~~~~~~~bb~~~~b~~b~~b~~~~~b~b~~b~~~~~~~~b~~~~b~~~~~~~~~~~~~b
~b~~~~~~~b~b~~~bb~~~~bb~~bbb~~~~~~~~~~~~~~~~b~bb~~bb~~~bb~~~bbb~bb~~~b~~~b~bbbb~~b~~b~~~~~~bb~bb~~~~b
~b~~~b~~~~~b~~~~b~b~~~b~~~~~~~~~b~~bbb~b~b~~~bb~~~b~~~~b~~b~~~bb~~~~~~~~~~b~~~b~~b~~~~~~~~b~b~~b~~b~~
~~~~~~~~b~b~~~~b~~b~b~~~~b~b~~~~bbb~~bb~~~b~b~~~b~~~b~~~~~~~~b~~b~~bb~~~b~~b~~b~~b~~b~~~~~~~bb~~b~~b~
~bbbb~~b~bb~~b~~~~~~~~~~~~~~~~~~b~~~~~~~b~~b~~b~~bb~b~b~~~~~~~b~~~~~~~bb~b~~b~~~~b~bb~b~~~~~~~bbb~~b~
~~~~b~~b~~~~bbb~~~bb~~~bbb~~~~~~~~~b~b~~~bbb~~~~~~~bbb~~~bbbbb~b~~~~~~~~~b~~~~~~~b~b~b~~~~~bb~~~b~~~b
~b~b~~~~b~~~~b~~~~~~~~~b~~~~b~~~~b~~bbb~b~~~~b~~~~bb~~~~~~~~~~~b~b~bb~~~b~bbb~bbb~b~bb~bb~~bb~~~~~~b~
~~~~~~b~b~~~~~~~b~b~~~~~~b~~~~b~~~~~~~~b~~~~~b~~b~~~b~bb~~b~~~~~~~~b~~~b~~~~~~b~~bbb~b~~bbb~b~b~~~~~~
~~~bb~~~~~bbb~~~b~~~~~b~~~~bb~~~~~~~~~b~b~bbbb~bb~~b~bbbb~~b~~b~~~~~~~~~~~~~~b~~b~bbbb~b~bbbbb~b~bb~~
~~~b~b~~~~~b~~b~~~b~b~~~~~~~b~~~~b~~~~~~~~~b~~~b~~~~~~b~~~b~bb~~~~~~bbb~b~b~~~~b~~~~~~~~~~~~b~~~~b~~~
bb~~~~~b~~b~b~~bb~b~~~~bb~~~~~b~~~~b~~~~~~~~~b~~~~~b~~~~~~b~~b~~~~~~~~~bbb~~bb~bb~b~~bbb~~~~~b~b~~~bb
~~~b~~~~~~~~~b~~b~~~~~b~~~~bb~~~b~~~~bb~~~~~b~b~b~~~~~~~b~~~~~~b~~b~b~b~b~b~b~~~~~~~~~b~~b~bb~~~~~b~~
~~~~~b~~~~~~b~bb~~~b~~~b~~~~b~~~b~~b~~~~~~~~~~bbb~~~~~~~~bbb~~~~~~~~~~b~bbbbbbbb~~b~bb~~b~~~~~~~~bb~~
bb~bb~~bbb~~~~~~~~~~~b~b~b~b~bb~~~~~b~b~~~~b~~~~~~b~~~~~~bbb~bbb~~~~~b~~bbbb~~bbbbb~~b~bb~~~~~~~~b~~~
~b~~~~bb~bbb~~~b~b~~b~~~~~~b~bb~~b~b~b~~~bb~~~~~~~b~~~~~~bb~bb~b~b~~~~b~~b~b~b~b~~~b~~~~bbb~b~~~~~~~~
b~b~~~~~~~~~bbb~~~b~b~bbb~~~bbbbb~~~~~~~~~b~~~~~~~~b~~~b~~~~~b~~~~b~b~~b~~~b~~~bb~~~~~~b~~~~~~~bbb~b~
b~bb~~b~~~bb~b~~~~~~~~~~b~~~b~~b~bb~~~~~~b~bb~~~~~bb~b~~b~bb~~~b~~~b~~b~b~~~bbb~~~~~~~b~~b~~~b~~~~~~b
b~~~bb~~~~~bb~b~~~b~bb~~~~b~~b~b~b~~b~~~~~~~~~~~~b~~~b~~b~b~b~b~b~~~~~~b~~b~~~b~~bbb~~b~~~b~~~b~~b~b~
~bb~~~bb~~~~~b~~~b~~bb~~b~~~~~b~bb~~~b~~b~~b~~b~b~~b~~~~~~~~~~~~~b~~~b~bb~~~~~~b~bb~~~~~b~~b~~b~~~~bb
~~~~~~~b~~~~b~~~~~~~~b~b~~~~~bbb~~~~~b~~~~~~~~~~~~bb~~~~~~~b~~b~~~~~b~~~b~bb~~~b~~bb~~~~~~b~~~~~~b~bb
bb~~bb~~~~bb~~b~~~~~b~b~~~~~~~~~~~~~b~b~~~b~~~~~~b~~~~bbb~~~b~~~~b~~bb~~~~~~~~~~~~b~~~~~~b~~~~bbb~bb~
~b~bb~b~~~~~b~bb~b~b~b~~~bbbbbbbbbbb~~bb~~~~~~~~~~~~~bb~bb~b~~~~~bb~~~bb~b~b~bb~~~~~~~~~~~~~~b~b~~~~~
~bbbbb~~b~b~~bb~b~~b~~bb~b~~~~b~~~~~~~~b~~~b~~b~~b~~b~~bb~b~~~~b~~bb~~~~~~~~~~~~~~~~~~~b~~~~~b~b~~~b~
~~b~b~~bb~~b~~~~~bb~~~b~~bb~~b~~~~bb~~~~~b~~~~~~~bb~~b~bbb~~~b~~~~~~bbb~~b~b~~~~b~bb~~b~~~bb~b~~~~bb~
b~~~~~~~~~~b~~~~b~~~~b~~~~~~~~b~b~~~~~~~~~~~~~bb~~b~~~~~~b~~b~~~~~~~~bbbbb~~~~~~b~~~~b~~~bbbbbbb~~~~~
~~~~~~~~~~~~bb~~b~~~~~~b~~~~~~~~~~~~~b~~b~~bb~~~~b~~~~~~b~~b~~b~b~bbb~~~~~bbbb~~~~~~~~b~~bbb~~~b~~b~~
~~~~~~~~~~~b~bb~bbb~b~b~~~~~~b~~~~~bb~~~~~bb~~~b~b~~bb~b~~~~b~~~~~~~~b~~~b~~b~~b~~~b~~b~b~~~~~~~~~b~b
~bb~~bbb~~~~~~~bb~~~~~~~~~~~~b~~b~~b~~~b~~~~~~~~~~~~~~bb~~bb~~bbbb~~~~~~~~bb~b~~bb~~~bbb~~~~~b~~b~b~~
~~~~~~b~~~~~~~~b~~b~~bb~b~~~~b~~bb~~bbbb~~bbb~b~~~~~~~b~~b~~b~~~~~~~~~b~~~~~b~~~~~~~~~~bb~~bb~~~~~~b~
bbb~~bb~~b~~b~~~~~~~~~~~~~~~b~b~bb~~b~b~~~~~~b~~b~b~~~~~b~~~~~~~~~~bb~bb~b~~~~~~bb~~~~~~bb~~~~~b~~~~~
~~~~~~b~~b~~~~~~bb~~~~~b~b~~b~~bb~~~~bb~~~~~b~~~b~~~~b~b~bb~~~~b~bb~b~~~~b~~~~~~~b~~~~~~~~~b~~~~~~~~~
bb~~b~~b~b~~~b~~~~b~b~b~~~b~~b~~~b~~~~bb~~~~~~~~~~b~~~~b~~bb~~b~b~b~~b~b~~~b~~~~~~~~~~~~bbb~b~~~~b~~b
~b~~~~~~~b~b~~~b~~~~bb~~~~~~~~bb~bbb~b~~b~bb~b~~~~~bb~~~b~~~b~~b~~~bb~~bb~~~~~bb~bb~~~b~~b~~~~~~b~bbb
~~~~b~b~b~~~~~~~~~~~~~~~b~b~~b~~~b~~~~b~bbbb~~~~~~~b~~~~~bb~bbb~~~bbbb~~~~~bbb~~~b~bb~~~~~bbb~~bbb~~b
~~b~~~~~b~~~~~~~~~b~~b~bb~bbb~~~b~~b~~b~~b~b~~~bb~~~b~~~~~~~~~~S~~b~~~bb~~b~~~b~bb~~b~~~b~b~b~b~bb~b~
~~~b~~~~~b~~b~~~~~~~~~~~~b~~b~~~~~~b~~b~~~~~bb~~~~~b~~~bb~~~b~b~~~~b~~~~~~~~~b~~~~~~~~~b~bb~~~~~~~b~~
bb~~b~~~~~bbb~bbbb~b~~b~~~~~~b~~b~~bb~bb~~~~b~~~~b~b~b~bb~b~b~~~~~~bbb~~~bb~~~~~~~~~~~~b~~~b~b~b~b~bb
~~~~~bb~b~b~~~~~~b~~~b~~~b~b~~bbb~b~~~~~~b~bb~~~bb~b~~~~~~b~~~~~~~bb~~b~~~~~b~~~~~b~~b~~~~~b~~~~~~~~~
b~~~~~b~b~~~~~~b~b~~~~bb~bb~~~b~b~b~bbb~~~~~bb~~~~~~~b~b~~~~bbb~~~~~~~~~b~~~~~~~~b~~~~b~~b~~b~~~b~~bb
~~~b~~b~b~~~~b~~~b~~~~~bb~~~~~~b~~~b~~~~~~~~~~b~~~b~~~~~~~~b~~~~b~~~~~~b~~~b~~~~b~~~~b~~~~~~bbbbb~~~b
~~~bb~~~~b~b~~~~~~~b~~bbb~~~bb~bb~~bbbb~~~~~~~~~~b~~~~~b~b~~~~bb~~b~~~~~~b~bbb~~~~~~~bb~~~~~b~~b~~~b~
~b~~bb~~~~~~bb~b~~~~~~b~b~~~~b~b~~~~b~~~~bb~~~~~~bbb~~~~~~~~~bb~b~~~~b~b~~~b~bb~~~b~~~~b~b~b~b~~b~~~b
~~~~b~bb~b~b~bb~~~~~~~~~~~~~~b~~b~~b~~~~~~~b~bb~bbbbb~b~b~~~~~~b~b~~~~~bbbb~~~b~~~~b~~b~~bb~b~~~bb~~b
~~bbb~~~~~~bbbbbb~~bb~~~~b~~b~b~~~~~~b~~~~~bb~~~~~~~~~~~~~b~~~b~~~bb~bb~~~b~~~b~~bb~b~bb~~~b~~b~~~~b~
~~~~b~~~b~~~~~~~~~b~b~b~b~bb~b~b~~~~~b~~~~~~~~~~bb~~~~~b~~~~~~~~~~bb~~~~~b~~~~~~~~~~~~~b~b~~~~~~~b~~b
bb~b~~~~~~~~~~~~bb~~~~bb~b~b~~~~b~bb~~bb~bb~~~~~b~~~~bb~b~b~b~bbb~~~~~~~~bb~~~~b~b~~~b~~b~~~b~~~b~b~~
~b~~bbbb~~~~~~~b~b~~~~~~b~~b~b~~~b~~~~~~b~~~~b~b~bb~~b~~~~b~~b~~bbb~~~~bbb~~bb~~~~~b~~~b~~b~~b~b~~~~b
b~~~~~~~~~~~~~~bb~~b~b~~~b~~bbb~~~b~b~~bb~~~~~~b~~~~~~b~~~b~bb~~~~~~~b~b~b~~~~~b~~b~~bbb~~~~~~~b~~b~~
~b~~~b~~bb~b~~~~~~~bb~~~~~~~~bb~bb~~~~b~~~bbb~~~~~~~~~b~~~~~~~~~~bbbb~~~~~b~~~~~~b~bbbb~~~~b~~~~~b~~~
~~~bb~~~b~~~b~b~~~~b~~~~~b~~b~~~bbb~~bbb~b~b~~b~~~~~~~~b~~bb~~~~~~b~~~~b~~b~b~~bb~~~~~b~~~~b~~~b~b~~b
b~~~~b~~~bb~~~~~~~~~~b~~~~~bb~~~~bb~~~~b~~~b~~b~~~b~b~bbb~~~~b~~~~bb~~~~~b~bb~bbb~b~b~~~~~~~~~~b~~~b~
~b~~~~~~~~~~~~~~~b~~~~b~b~~b~~~bb~b~b~~b~b~~~bb~b~~~~~~bb~~~~~~~~~~~~b~~b~bb~~b~~~~~b~~~~~~~~~~~b~~~~
b~b~~~~bb~~~~~b~bb~b~~~~b~~~~~bb~~~~~~~b~~~~~~~~~~~~~b~b~~~~~~~bb~~~~~~~~~~bb~~~b~~~b~b~~~~~bb~~~b~~~
~~~b~~bbbb~~~~b~b~~~~b~~~~~bb~bb~~~~~b~~b~b~~b~bb~~~~~b~~~~~~b~~bb~~b~~~bbb~~~~~bb~~~~~~~~b~~b~~b~~~~
~~bb~bbbb~~~~~~b~~~~b~bb~~~bb~~~b~b~~b~~~~~b~~~~b~~~b~~~~~~~~bb~~~b~~~~~~~~~~b~~~~b~~~~~b~~~b~~~~~b~~
b~~~~~~~~~~~~b~b~~b~~~~~~~~bb~~~~b~~~~~bb~b~b~b~b~~~~~~~~~b~~~~~b~bb~~~~~bb~~~~~~bbb~~~~~~~~~b~~~b~~~
~~~~~~~~b~~~~bb~~b~~bb~b~~~~~~~~~~~~~b~~bbb~b~~~~~~b~b~~~b~b~b~b~b~b~~~~~b~~~b~~~~~~~b~~~b~bb~~b~~~~~
b~~~~~~bb~~~~~b~b~~~~~~~b~~b~~b~~bb~bb~~b~~~~~~~~~~~b~b~~b~~~~~~bb~~~~~~b~~b~b~bb~~~~~~~~~~~~~b~b~~~~
b~~~~~~~~~~b~~bb~~~~b~b~~~~~~~~bbb~~~~bb~bb~~~~b~~b~~~~~~b~b~~~~~~~~~~b~~b~~b~~~~~~~bb~~~~~~~~~~~~~~~
~~b~~b~b~bbb~~b~~~~b~b~~~~~~~~~~~~~~~b~~bb~b~bbb~~b~b~~~bb~b~b~~~~~~~b~~~b~b~b~~~bb~~~~~~~b~~~~~~b~~~
~~~~~~~b~b~~~~~~~~~~b~~b~b~~~b~~~bb~~~~~b~~~bb~~~~bb~~~~~~~~~~~~~~~~~~~~~b~~bbb~~b~~~b~b~~~~~b~~~~b~~
bb~~~b~bb~~b~~~~~b~~b~~~~b~~~b~b~~~bb~~~bb~b~~~bb~~b~~bbbb~~~bb~~~~~~~~~~~~~b~bb~~~~~~~bb~~~b~~bbb~~b
~~bb~~bb~~~~~~~~~b~b~~~bb~~~b~b~b~~b~~b~~~b~~~~bbb~~~~~~~~~~~~~~b~~b~b~~~~b~b~~b~b~~~b~~~b~~~~~~b~~~~
b~bb~bb~b~~b~~~~b~~b~b~~b~~b~~~~~~~~bb~b~b~~~b~~b~~b~bb~~b~b~b~b~bbb~~bb~~~~~~~~bb~bb~~~~~~~~~~bb~~~~
~~~b~~~~~~~~~bb~~~b~b~~~~~~~~~b~~~~bb~~~~~~~b~bb~~~~~~~~b~bb~bb~b~b~~~~b~b~~~~~~~~bb~~bb~~~bb~~~~~~b~
~~bb~~~~~b~~~bb~~~~~~~~~~~~~~b~~bb~b~~~~~~~~~~~~~~~~~bb~~bb~~~b~~~~~~~~b~~~b~~~bb~~b~~bb~~~~~~~~~~b~~
~b~bb~~~~b~b~~~~b~~~~~~~~b~b~~~bb~bb~~b~~~~~~~~~~~~~~~b~~~~bb~~~bb~bb~b~~b~~~~~~bbbb~~b~~~b~~b~~bbb~b
b~~~b~~bb~~~~~b~~~~~~~~~~b~~~bb~~b~bb~~~~~~~~bb~b~~b~~~~b~b~~~~~b~~~~b~~~~~~~bb~~~b~b~~~b~~~~~~~bb~~~
~~~b~~b~~b~~b~~~~~~~~~~~b~~~~~~~~~~b~~bb~~~~~~~~~~b~~~~~b~~~~b~~~~~b~~b~~~~~~~bb~~~bb~~~~~bb~~~~b~~b~
~~b~~b~~bb~~~b~b~~~~~~~~b~bbb~~~b~~~~b~~~~bb~~b~~~~~bb~~b~b~~~b~~b~~b~~~~~~b~~~b~~b~~~~~~~~~~~b~~b~b~
~b~~~~~bbb~b~b~bbbb~bbb~~b~~bb~~~~~~~b~~~~~~bb~~~~~~~~bbbb~b~b~~~~~b~~~~~~b~~~~~~~b~bb~bb~~~b~~~~~~~~
~~b~b~~~~~~~bb~~~~~b~~b~b~~~~b~~~b~bbb~~~b~~b~~bbb~~bb~~~~~~~~~~~~~~~~bb~~b~~bb~~b~bbb~b~~~~~b~bb~~b~
~~~b~b~b~~~~b~~~~~bb~bb~~~~~~~~~~b~b~bb~~~~~~~~b~~~~~~~b~~~~~~~~~~~~b~~~b~~bb~~bb~~~~b~~~~~b~~~bbb~~~
b~b~~~~~~b~~b~~~~b~b~~~~~~~bb~~~~~~~~b~~b~b~~~b~~~~~~~~~~~bbb~~b~bb~~bb~~~~~b~~~~~~b~~bb~~~bb~~~b~b~~
~~~~~~b~~~~~~~~~~~~b~bb~~~~~~~~b~b~b~~~~b~b~~b~~~~~b~b~~~b~~~~~bb~~~b~~~b~b~~~~b~~~~~b~~b~~b~~~b~~~b~
~~~b~~~~~~bbb~~~~~~~~~b~b~~~bb~~b~~~~~~~~~b~~b~~~bb~b~~bb~~b~~~~~~~~~~~b~~~~~~~~~~~~~~bbb~b~~~bbb~b~~
bb~~~~~~~~~~~~~~b~b~~~~~b~~~b~~~~~~~b~~~~bbb~~bb~~~b~bb~~~~b~~b~~b~~b~~~~bb~~~~~b~~~~b~bb~~~~~~~bb~~~
~~~b~~b~~~b~~b~~~~b~bb~~~b~bbb~~~~~~~~bb~b~b~~b~~~~b~~~b~~~~b~b~bb~~b~b~~b~b~~~b~~~~b~b~~b~~~b~~~b~~~
