~~~~~~~~b~~~~b~b~~~~~b~~~~b~b~~b~bbbb~b~~~~bb~bb~~~~b~b~bb~~bb~~~~b~~b~~~~b~b~~~~bb~~~~~~~~~~~b~~~~~b
~~~~~~~bb~b~~~b~~bb~b~~bb~~b~~~b~~~b~~b~bbbbbb~b~~b~~~b~bb~~~~bb~~~b~~~~~~~~~~b~~~~~~~~~~~~~~b~~b~~~~
b~b~~~~b~~~~~~~~~~~~~bb~~~~~~~~~~~~~~b~b~b~~~~~~~~~~~~~~~~~~~~~b~~~bb~~b~~~b~~~~~~~~bb~~~~bb~~b~bbb~~
~~~~b~b~b~~~~~b~b~~~~~~~~~bb~~~bb~~~~~b~~~~~~~~~~~~b~~~bb~bb~bb~~~b~~~~b~~~~~~~b~b~b~~~b~~b~~~~b~~~~~
b~b~~b~b~~~~bb~~b~~~~~~~bbb~~bbb~b~~~b~~~~~~~~~bb~~b~~~~~~~~~~~b~~~b~~~~~~~b~~~~~~~~~b~~b~~b~~~~~~~~b
bb~b~~b~~~~~~bb~~b~~~b~~~~b~~~b~b~~~~~~~b~~bb~~b~b~bbb~b~~~~b~~~b~~~~bb~~~~b~~~~b~~~~~~~~~b~~b~~~~bb~
~~~~~~~~~~~~~~b~~bb~~~~bbb~~~~bbb~~b~bb~~b~b~~~~~b~~~~~~~~~bb~b~~b~~~b~~~b~~~~~~bbb~b~~b~~~~~b~~~b~~~
~~~b~~~b~~~~~bb~b~~b~~~bb~b~~~b~b~~~~~~~~~~~~~~b~~~~~~~b~~~~~~bb~~~~~b~b~~~b~~~~~~bb~~~~b~b~~~~b~~bbb
~~bbb~~~~b~b~~~bbbbb~b~~b~~~~bb~bb~b~bb~~~~~~~~~~b~b~b~~~~~b~~b~bb~~~b~b~~~b~~~~~~~b~b~b~b~bbb~b~~b~~
~b~~~~~~~b~b~b~b~~b~~~~b~bbb~~~~~~~b~bb~~b~~~~~~~bb~~~~~~~~b~~~~b~bb~b~~bb~b~~~~~b~~bb~~b~~b~b~~b~~~~
~bb~~~~~~~~b~~b~~~~~~~b~~~~~~b~bb~~~b~bbb~~b~~~~~~~bb~~~b~~~~~bb~bb~~~b~~b~~~~~b~~~b~~b~~~~~~~~b~b~~~
~b~~~~b~bb~bb~b~b~~~~b~bb~~b~bbbb~~b~~bb~~~~b~~~bb~~b~bb~~b~~b~~bb~~b~~b~~~~~~~b~bb~~~~~~~~~~b~~~~~~b
b~b~~~~b~~~~b~~~~~~~bb~~b~~bbb~~~~~b~~~~bb~~~b~b~b~~bb~~~b~b~b~b~~bb~~b~~~~~b~b~b~b~~~b~~~~~~~~~bb~~~
~~~~~~~~~bbbb~~~~~b~bbbb~~~b~~b~bb~b~~b~~~~~~b~b~b~bb~~~~~~~~~~~~b~b~~bb~~~~~~b~~~~b~b~~~~~~~~~~~b~~~
~~bb~~~b~~~bbbb~~~b~b~~~~~bbb~b~b~b~b~~b~~~bb~~b~~~bb~~b~b~~b~~~~bb~~b~~~~~b~b~~~~~~~~~~b~bb~b~~~~~~~
~~~~~~~b~b~~bb~bb~~~~~~b~~~~~b~~b~b~~~b~~~~~~~~~~~bb~b~b~bb~~~b~~~~~~b~~bb~~b~~~b~~bb~~~~b~~~~bb~~~bb
~~~~bb~~~~~b~~b~b~~~~b~~~~~b~~~~~bbb~bb~~~~b~b~~b~~bb~~~~~~b~~~bbb~~~~~~~bbbb~bb~~~~b~~~b~bb~~b~~~b~b
~~~~b~b~~~b~~~~~~b~~~~~~b~~bb~~~b~~b~~~~b~~~~~~~bb~~~b~bb~~b~b~~bb~~~bb~~~bb~~~b~~~b~~~~~~~~bb~~~~b~b
b~~bbb~b~~~~~~~~~~~bb~~~b~~b~b~~~~~~bb~~~~~~b~~bb~~~b~~~~~bbb~~~b~b~~~~~~b~~bb~~b~b~~~~b~~~~b~~bb~~~~
~~~b~~b~b~~bbb~~b~bbbb~~b~~~~~~b~~~~~~~~b~~~b~b~~~~~~~~~~~~~~~~b~b~b~~~~~~~bb~b~bb~~~~~~bb~~b~~~~~~b~
b~~~~~~~~b~b~b~~~b~~b~~~~bb~~~~b~~b~~~b~b~b~~bb~~~~bb~~~b~~~~~~~b~~~~~~b~~~~~~b~b~~bb~~~~~b~~~b~~~~~~
~b~b~b~~~~~~b~b~~~bbbbb~~~~b~b~bb~~~~b~b~~b~~~b~bb~~~bb~b~~bb~~~b~~~~~bb~~~~b~~b~b~~b~b~~~b~~~~~~~b~~
b~~~bbbb~b~~~~~~~~~~b~~~~~~~~~~b~~b~~~~~~~b~~b~b~~bb~~bbb~b~~~~~~~~~~~bb~~~~~~b~~~~~~~~~bb~bb~~~~b~b~
b~b~b~~~bb~~~~~b~b~~b~~bb~~~~b~~~b~~b~b~bb~~~~~~b~~~~~~b~~b~~~~~~~b~b~~~~~~~bb~b~b~~b~~~~~~~~bb~b~~~~
~~~~~b~b~~~~bb~~~~~~~~~~~~~b~~~~~bb~~b~bb~~~~b~~~~~~~~~b~b~bbb~~~~bb~~~~~~~~b~b~~b~~~~~~b~~~~~~bbb~~b
~~~~~~~~~~bb~~~~b~~~~~~~~b~~~b~~~~~~~b~~~b~b~~bb~~~~~~b~~~b~~b~~~~b~~~~b~~b~bb~~~b~~~b~~~~~~bb~~b~~~b
b~~~~~~bb~~~b~~~~~~~b~~~b~bbbb~~~b~~~~~~~~~~~~bb~~~~~~~~bbb~b~~~~b~~~b~b~bb~~~~~~~~~~b~~~~b~~bb~~b~~~
~b~b~~~b~~~~~~bbb~~~~~~b~~~~~bb~~~~bb~b~bb~~~~bb~b~~~~b~~~~~~~~~~~b~~~~b~~~~b~~bb~~~~~b~~b~~~b~~~b~~b
~~~bb~~b~~~~~b~~bb~bbb~bb~~~bb~~~~~~~~bb~b~~~~bbb~~~~~bbbbbbb~bb~~b~~~~~~~~~~b~~bb~b~~~~b~b~~~~~~~~~~
~b~bb~~~b~~~~~b~~b~b~~~~b~b~b~~bb~b~~b~bbb~S~bbbbbb~~~~~~b~b~b~b~~bb~~~~~~b~~b~~b~~~~~bb~~~~~~b~~~~~b
b~~~~bbb~bb~~bbbbb~~~bbb~~~~~b~~~bbb~bbb~bb~~~~~~~b~~b~~~~~~~~~~~~~~~~b~~~~~~b~~~~~~~bb~~~~b~~b~b~~bb
bb~~~~~~~bb~~~~~~b~b~~~~~~bb~~b~~~~bb~~~~~~b~~~~b~b~~~~b~~~b~b~b~~~~~~b~~b~b~~~~b~~~~~~~~~b~~~bbb~~~~
~~~~~b~b~b~b~~~bb~b~b~~~~bbb~~~b~~~~~~~bbb~~~~~b~b~bbb~~~b~~bb~~bbb~~~~~~~~~~b~~b~~~~b~b~b~~~b~~~~b~~
~~b~~~~~~~~~bb~~~~~~~~~b~b~bb~b~~~b~b~b~~~~b~~~~~~b~~~b~~~~~~~b~~bb~~~~bb~~bb~b~~~~~b~~~~~~~~~~~~~~~~
~bb~~~~~~bb~~~~~~~b~b~b~~~~~b~~~~~~b~~b~~~bb~bb~~~b~~~~~bbbb~b~~~~~~~~~~~~~~~bb~~~~~b~~b~b~b~~~~~~~~~
b~~b~b~~~~bbb~~~~~~~~b~~~b~~~b~~~~~~~bb~~~~~~~~~~~~~~b~~~b~~~~b~~~bb~b~~~~~~b~bbb~~~b~~~~~~~~~~b~~b~~
b~~bbb~b~b~b~b~b~b~~~b~~~~b~b~~b~bb~b~~~b~~b~~bb~~~~bb~~~~~~~~b~~~~~~b~~~~~~b~~b~b~~bb~~bbb~b~b~~bb~~
b~~~bb~~~~~~b~~~b~b~~~~~~~~~b~~~bb~~~~~~~~b~~~~~b~~~bb~~~~~~~b~~b~b~~~b~~~bbb~b~~~~~b~b~b~~~bb~~~~b~~
~~b~~b~~~~b~~~~~b~b~~~~~~b~~~~~~~~b~b~~~~~~~~~~~b~~bb~b~bb~~b~b~~~bb~~~~b~b~b~~~b~bb~b~~~~~~~~~~~~~~b
b~~~~b~bbb~bb~bb~~~~~~b~~~~b~b~~b~bb~~bb~~~~~b~~b~~bb~bb~~b~~~bb~b~~~~~~b~~~~b~~~~~~~b~~~bbbb~b~~~~~~
b~b~~bb~b~~~bb~~~b~~~~~~~~~bb~b~b~~b~b~~~b~~~b~~~~~~bb~~b~b~~~b~~bbb~b~~~~~~b~b~b~~~b~~bb~~~~~~b~~~~~
~~~b~~b~~~~b~~~bb~~~~b~~~~~~~~~~~~bb~b~~~b~b~~~~~b~~bb~b~~~~b~~~bbbb~~~~~b~~b~~~~~~~~~~~~~~b~~~bb~~~~
~bb~~b~b~~~~bbbb~~b~b~~~bb~~~~~~~~~~b~~~b~bb~~~~~b~b~~b~~b~~b~~~~b~~~bb~~~~bb~~~b~~b~~~~~b~~~b~~~~b~~
~b~b~~~~b~b~~~~~b~~~bb~~b~~~~~~~~b~b~bb~b~~~bb~b~bbbb~~~~~b~~~~b~~b~~b~~bb~~~~~~~~~~~~bb~~bbb~~~~~~b~
~~~~~b~~~b~b~b~b~~b~bbb~~b~~bb~b~~~~~~bb~b~~~b~bbb~~~~~~bb~b~~~~~~b~bb~~~~~b~~~bbb~~~~~b~bbbb~~~bb~~~
~b~~b~b~~~b~b~b~~~~b~~~~b~~b~~~~~~~b~b~bb~~~~~~b~bbb~b~b~~b~~~b~bb~~~~~b~~~~~~b~~b~b~~b~~b~bbb~~b~~~~
~~~~~b~~~~b~bb~~~~bb~~~~~~bb~b~~~~~bb~~b~~b~~~~b~b~~~~b~~~~~~b~b~b~~b~~~bb~~~bb~~~~~b~~~~~~~~~b~~~~b~
~~b~~~~~~~~b~~b~bb~~~~~~~bbb~~~~~~~b~~b~b~b~~~~~~b~~~~~~~~~~~~~b~~~~bb~~~b~~~~b~~~~~b~~~~~~~~~~~~~b~~
~~b~b~~~~~b~~~~~b~~~~~~~~~b~~~~~b~~~b~b~b~~~~b~b~~~~~bb~b~b~~~~bbb~~b~b~~~~bb~~~b~~~~b~~~b~b~~~~~~~~~
~~~~bb~b~~b~~~~b~~~~~~~b~~~bb~~b~~~~b~~~~~~~~~~~b~~~b~~b~b~~bb~~~~bb~b~~~~~~b~~~b~~b~~~b~~~b~~~b~~b~~
~~~~b~bb~~~~~b~~~b~~~~~~~~b~~b~b~~~~bb~~bb~~~b~~bb~~b~~bb~~~~~bb~~~~~~b~b~~~~~~~~~~~b~~~~~bb~~b~~~~~b
~~b~~bb~~b~b~~~b~~~~~b~~~~~~~~b~~~bb~~bbb~~~~~b~bbb~b~~~b~~bbb~b~~~~~bbb~b~~~~~~~~~bb~~~~bb~~~~~~~~~~
~bb~bb~bbb~b~~b~~~bb~~~~bbb~~b~~~~~~~b~~b~~~~bbb~bb~~b~bb~~b~~~~~b~b~b~~~~bb~~b~~~~~bb~b~~~~b~~~~~~bb
~b~b~bbb~~~bb~b~~b~~~~b~bb~~~~~~~~~~~~~~b~~~b~~~~b~~~~~~~bb~b~~~b~~~~~bbbbb~~b~b~bbb~~~~~~bbb~~~~~~b~
~~~~~b~~~~b~~~~b~~~~~bb~b~~~~~~~b~~~bb~b~~~~b~b~~~~bb~~~~bbbb~~b~~~~b~~~~bb~~~~~~~b~~~bb~~~b~~~~b~~~b
~~~bb~b~~bb~b~~~b~~b~~b~~~~~~~~~~bb~~~~bb~~~~b~~~b~~~~bbb~~~b~~~bb~~b~bbb~~~bb~~~~~~~~~~~~bb~~~bbb~bb
~~b~bb~b~~~b~~~~b~b~b~~b~~b~b~~~~b~~b~~b~~~~~b~b~~~b~~~bb~~~~bbb~b~bbb~~~b~b~~~~b~~~b~b~~~~~~~~b~bb~~
~~~~~~~~~b~b~~~~~~~~bbb~~b~bb~b~~~~b~b~bb~~b~b~b~~bb~b~~~~~b~bbbb~~b~bb~b~~~~~b~~~~bb~~~~~bb~~~~b~~~~
~b~~bb~bbb~b~~~b~~~~~~b~~~~~~b~~b~~bb~b~b~b~~~~bb~~bbb~~~~~b~b~bbb~~b~~~b~b~~~~~~~b~b~~~~b~~~~~b~b~~~
~~b~~~~~~~~~b~~b~b~b~~~~b~~~~~~~~b~b~~~b~~~~~~b~~~b~~~b~b~~b~b~b~~~~~~~~~~b~~~~~~~~~~~~~bb~~~b~b~~~~~
b~~~b~~~~b~~bb~b~b~~~b~bbbb~~~bb~~~b~~b~~bb~~~~~~~~b~~~~~b~bb~~bb~~~~~~b~b~~~~b~bb~~~~b~~~b~~~~~~~~~~
~b~~~bb~~bb~~b~~~b~bb~~~b~~~~~~~b~~~~~b~~b~~~~~~b~~~~b~~~b~b~~~~~~bb~~~~~~b~~~~b~~~b~b~~~~~~bb~~~~b~b
bbb~~~b~~~~~b~~~~b~b~~b~~b~b~~~b~b~~~~bbb~~~~~~b~~b~b~~bb~~~~b~~b~~~~~~b~bbb~~~b~~~~bb~~~~~~~~b~~~~~~
b~~bbb~~~~~~~~~b~~~~b~~b~~~~~~~~~b~~~~~b~~~~bbb~~~~~~~~b~bb~~~b~b~~~~b~~~~~b~~bb~~~~~~~~~b~~~~~~b~~~~
bb~~~~~~~~~~b~~~b~~~~~Gb~b~~bb~b~~b~~~~~~~b~~b~~~~~~~~~~~~b~b~bb~~~b~~~~~~~bb~~~~~~~~b~~bb~~~~~~~bb~~
~~bb~~~~~~~~~~b~~~~b~~~b~~b~~~~~~~~~b~~b~~~~~b~~b~~~~~~~~~~~bb~~~~b~b~b~bb~~b~~~~~b~b~~~b~~~b~~b~~~~~
b~~~~~b~b~~~b~~~~bbb~~~~bbb~~~b~b~~b~~~~~~bb~bb~~~~~~b~b~~~~~bbb~~~~~b~~~b~b~~~b~~bb~b~~~~~~~~~b~~~b~
~~~~~~~~~~~~~b~~bbbbbb~~~b~~~~~bb~~b~~bb~bb~~~bb~~~~bb~~~bb~~~b~b~b~~b~~b~~~~~~~~~~~~~~~b~~b~~~b~~~~~
~~~~~b~~b~~~~~~~~~bbb~~b~b~bb~bbbb~~~~b~~bb~bbb~~~b~~~bb~b~~~~~~~bb~~~~b~~~~~~~~~~~~~b~~b~b~b~~~~~~b~
~b~b~~~~b~~b~b~~b~b~~~~~~b~b~bb~~~~b~~~~~~bb~~~~~~b~~~~~b~~b~~~~~b~~~b~~~~~~~~~~~~bbbb~b~b~~~~~~b~~~~
~~~~~~~~b~~~b~~b~~~~bb~b~~b~b~~~bb~~~~~bb~b~~~b~b~~~~~bbb~~b~~bbb~~~b~~~~~b~bbb~~b~~~~~bb~bbb~~~~b~~~
b~~~b~~~~~bb~~~b~b~b~b~~~~~~b~~~~~~~~~~~~~b~b~~~~~~~bbb~~~~~~~~b~bb~~~~~~~~b~~~b~~~~~~b~~~~b~b~~~~~b~
~~~~~~~~~~bb~bb~~~~b~bb~~~~~b~~~b~~b~b~bb~b~~b~bbb~bb~~~~~~~bbb~~~~~~~b~b~~~~~~bb~~~~~bb~bb~~bb~~b~~b
~b~~~~~~~b~~~~~~~b~~~~b~~~~~~~bb~b~bbbbb~bbb~~~~b~b~b~~~~bb~~b~bb~b~~b~~b~bbb~~~~~b~~~b~b~~~~~b~~~bb~
~~~~~b~b~b~b~~bb~~~b~bb~b~b~~~~b~~~~~~~bb~~~~~~b~~bbb~b~~~~b~b~~~~~~~~~bb~bb~~bb~~b~b~~~b~bb~b~~~~~~b
b~~~b~~bb~~~~~~~b~~~~~~~~~~~~~b~~~bb~~~b~~b~bb~~~~b~~~b~bb~~~~~~~~~~~~~~bb~b~~~~~bbbb~b~~~~~bb~~~~~b~
~b~b~~b~~bb~~~b~~~~~b~b~~~~~b~~~~~~b~~~~~~~~~b~b~b~~b~~~~~~b~~~~~~~~~~~~~b~~~bb~~~~~~bbbb~~~~~~~~~bb~
b~~~~~~bbb~b~b~~~~b~~~~~~~~~b~~~~~b~~~~~~~~~b~~bbbb~~~b~~~~~b~~~bb~bb~b~~b~~~~~bb~~~b~bbb~~b~~b~~~bb~
bb~~b~~~~bbb~b~~b~b~bbb~~b~~~~~bb~b~b~~~~~~bb~b~~~b~~~~~~~~~~~~~b~~b~~bb~~bbb~bbb~~~~~bb~~~~b~~~~b~~~
~b~b~bbb~~b~~~bb~~b~~b~bb~bbb~b~~~bb~~~b~b~~~~b~b~~~b~~~b~~~~~b~~~~~~~~b~~~~~~~~~~bb~~~b~~~~b~~b~~~~~
~~~~~b~~~b~~~~~b~~~b~b~~~~~~bb~b~~~b~~~b~~b~~b~b~~b~b~b~~~~~~~b~~b~~~~~~~~~~~~~b~~~~~~~~~~~~b~~~~~~~~
~~~bb~~~~~~b~~~b~~~~b~~~~~~~~~~~b~bb~bb~b~b~~~~~~~~~~~b~~b~~~~~~~~bb~~~b~~~~b~~~~~~bbb~~~~b~b~~~~~~~~
~b~b~~~~~~b~~bb~~b~~bb~b~~~~~~b~~~b~~~~~~~bb~~b~~b~~b~~~~~b~~b~~~b~~~b~~bbb~~~~bb~b~bb~bbb~~~~b~b~~~b
~b~~~~~~~~b~~~~~b~~~~~~~~~~~b~~~~~b~~~~~~~~~~b~~~~b~~b~~b~~b~b~b~~~~b~~~~~~~b~~b~~~b~~~~~~~~~~~~bb~b~
~~~~~~bbb~~~~~bb~bb~~bb~~~~~~~~b~~~~~~b~~~~b~~~b~~b~~b~~~~~~~b~~~~~~~~bb~bb~~bb~~b~b~~~~~~~~~~~~~b~bb
~~~~b~b~b~b~~~~~b~~~bb~~~~~~b~bb~~~~~~b~~~~b~~~~~~~~~~~~bb~bb~~~~~~~bb~~~~b~~bbbb~bb~b~bbb~~bb~~~bb~~
~~b~~b~~~~~~~b~~b~~~b~~b~b~b~~~~b~b~~~~~b~~~~~~~~b~~~bbb~~b~~b~b~~bb~bb~~~~b~b~b~~b~b~b~~b~~~b~~b~b~~
bb~bb~~~~~~~~~~~~~~~~~~~~~~~~b~~b~bb~~~b~b~~~b~~~b~~~~~~~~bb~~~~~~~b~~~b~~b~~~~~~~~~~~~bb~~bb~~~b~~~b
b~~bbb~~~b~b~~~~~b~b~bb~b~~~~~~b~~~~b~~~~~b~~~~~b~~~~~~bb~~~~~~~~b~~~~~b~bbb~~bbbb~~bb~b~b~~~b~~b~~b~
~~bb~~~b~~~~~b~b~~~b~bb~b~~bb~~b~~~~~~b~b~~~b~~~~bb~b~~bb~b~~b~~~~~~b~~~bb~~~b~~~~~b~~~~~~~bb~~~~~bbb
~~~~b~~~b~bb~~~~~~b~b~~b~~bb~~b~~~bb~b~~~~b~bb~~~~b~b~b~b~~~~b~~~~~~~bb~~~~b~~~~~bb~~b~~bbb~~b~b~b~b~
~~~~~b~~b~~~~bb~b~~~~~~~b~bbb~~~b~~~~bb~~~b~~~~~~bb~~b~~~~~~~~~b~~~~~b~bb~~~~~bb~~~~~bb~~~~b~~bb~~b~~
~~~~~b~~~~~b~~bb~bbb~~~~b~~b~~~~~~~~~~~~~~b~b~bbb~~b~~~~bb~~~~~b~~~b~b~b~b~~b~~~~b~b~~bb~~~~~~~~~~~~~
~~~~~~~~~b~~b~~~~b~~b~~~~~~~~bb~~~~bb~~~b~~b~b~~~b~~~~~b~b~b~~~~~b~~~~~~bb~~~~b~~~~b~~~~b~~~~b~~~~~b~
b~~~~~~b~~~~~b~bb~b~b~bb~~~~~b~~~~b~~~b~~b~~~~~~~b~~~~~~~~bb~~~~~~~~b~~~b~~~bb~~~~b~~~~~~~b~b~~bb~~~~
~~~~b~~~b~b~b~b~~~~~~b~b~~~~~~~~b~~~~~~b~b~b~~b~~b~~~~~~~~~~b~~bbbbbbb~~~bbbb~~~~~bbb~b~~~b~~~b~b~~~b
~~~~~b~~b~b~~~~~~~b~~~~~~~~~~~b~~~~b~bb~bb~~~bbb~~~~~~~~~b~~b~~~~~~~b~bbb~~~bb~~bb~~~~b~~b~~~~b~~~~~~
b~~~~~~~~b~b~~b~~b~~~~~~~~~~~b~~~~~~~b~~~~~~~~~~~b~~~~~~~~~~b~~~~b~~~~~b~~~b~~~~~~~~~~~bb~~b~b~~~bb~b
~~bb~~~~~~~~~b~~~~~~~~~~~~~~~b~~~~~~~~b~~~~~~~~b~~~~~bbb~~~~~b~bb~~b~b~~~~b~~~b~~~~~b~~~bb~~~b~~bb~bb
~~b~~~~b~bb~b~~~bbb~~bbb~b~~~b~~b~~~~~b~~~~bb~~~~~~b~b~~~~bb~~~~~~bbb~~~~~b~bbbb~~~~~~~bb~~b~~b~~~~~~
~~~~bbb~~~b~~bb~~~b~~~~b~~b~~~b~~b~b~~~bb~~~~b~~~~b~~~~b~~bb~~~~~bbb~~~~bb~~~~~~~~~~~~b~~b~~bb~~~~~~~
