~~~~~~~~bb~~~~bbb~~~~~b~~~~b~b~b~~~~b~~b~bbbb~~b~b~b~~~bb~~b~~b~~b~~~~b~~~bb~b~~bb~bbb~~~~~~~~~b~~~~b
~~b~~~~~b~b~bb~bb~~~~b~b~~bb~~~b~~~~~~~bb~b~~b~~b~bb~~~~~b~b~b~~~~b~~~~~~~~b~~b~~b~~b~bb~b~~~~~~b~~~b
~~bb~~~~~b~b~b~b~~bb~bbb~bbbb~~~~b~~~~~~b~b~~bb~b~~~~b~~~b~~~b~bbbb~~~~b~~bbb~b~~b~~~~~~b~b~~~~~~~~~~
b~~~~b~~~b~~~b~~~~~~~b~b~~b~~~~b~bbb~~b~b~~~b~b~~~b~~~bb~~~b~b~~~b~~b~~~~~~~~~~~~~~~b~~~b~~bb~~~b~~b~
~b~~~~~~bb~~b~~~b~~~~~b~~~~~~~~~~~~~b~~~b~~~~~~bbbb~~b~~~~~~~b~~b~b~b~b~bb~~~~~~b~~b~~b~~~~~~b~~~bbb~
b~~~b~~~~~~~~~~~~~~~~~b~b~~~bb~~~~~b~~~~b~bbb~~~~~~~~b~~~b~~~b~~bbbbb~~~~~~~~~~~~~b~bb~~b~~~b~~~~~~b~
~b~bbbb~~~~b~~~~~~~~~~b~~~b~~b~bbb~~~~b~bb~~~~~~b~b~~~~~b~~~~b~~b~~~bb~~b~b~~~~~~~b~~~~~b~~~~~~b~~b~~
~b~b~~b~~b~bb~~bb~~~b~~~~~~~~~~~~b~~b~b~bbb~bb~~~~~~~~~~b~~~~b~~b~~~b~~bb~bb~~~b~~~~~~~~~b~~~bbbb~~~~
b~~~b~b~~~~~~b~b~b~~~~~bb~b~~b~~~~~~~~~~~b~b~b~~~~~bbb~~~b~b~b~~~~~~~~b~~b~~~~b~~~~bbbbbb~~~~~~bb~~b~
~~~~~b~bb~~~~b~~~~b~~~~b~~~b~~b~~~bb~b~b~b~~~~~b~b~~~~b~b~bb~b~~~~b~bb~b~~~b~~bb~~~~b~~~~~~~~~b~b~~~b
bb~~b~~~~~~b~~~~b~~~~~b~~~bb~~~~~b~~~~b~~~~bb~b~bb~~~~b~~bbb~b~~~~~~bb~bb~bb~~b~~~~~b~bb~~~b~~~bbb~~~
b~~~bb~b~bb~~~b~b~~~~b~~~bb~~~~b~b~~~b~~~~b~~~b~~~~b~~~~b~~~~bbb~~bbb~b~~~~~bb~~~~~~~~~~~~~~~b~~~~b~~
~~~~bb~~~~b~~b~~~~~b~~b~~~b~b~~~bb~~~b~~b~~~~~~b~~b~~~b~~b~b~~bbbb~~~b~~b~b~~~b~b~bb~~~bb~~~b~~~~bbb~
bbb~b~b~~~b~~~b~~b~~b~bb~b~~~~bb~~b~b~bb~~~~~~~~b~b~bb~~~b~~~b~bb~~~b~b~~~bb~~~~~b~~bb~~~~~b~~~bb~~~~
~~~~b~~~~~~~~b~b~b~~~~~~~~~b~~~~~~~~bb~b~~b~~~~~~~bb~~~bb~bb~~b~~~b~~bbb~~~~~~b~~~~b~~~~~b~~~~bb~b~~~
~~~~~~~bb~~~~~~~b~b~~b~~~~~~b~~bb~~~~~b~~~~~bb~b~b~~b~~~b~~bb~~~~b~~~~~b~~~~~~~~~~b~~~b~~~~~~~~~~~~b~
b~~~~~~~~~bb~~~~~bb~~~~b~~~~~b~~bbb~~~b~b~bb~~~b~~~b~~~~~~~~~~bb~~b~~~b~~~~b~~~~~~~~~bb~~~~~~~~~~~~b~
~~b~bbbbb~~~~~~~~~bb~b~~b~~~~~~~~b~b~~~~b~~~~~~b~~~~bb~~~bb~~~b~b~~b~~~bb~~bb~~~~~~~~~~~~~~~bbb~b~~~~
~~~~~bb~bb~~bb~~bbb~~~~~~bb~b~~b~~b~~~~bbb~~~~b~bb~~b~~~~~b~b~bb~b~~~~~~~~~~b~b~b~bb~~~~~~b~~b~~~~~~~
~~~~b~~~b~b~~~b~bb~b~b~~~b~~~~~~~~b~~~bb~~~~bb~~~b~~b~~b~b~bb~~~~~b~bb~bb~S~~~bb~b~~b~~~~~~~b~~~~~bbb
b~~bb~~~b~~b~b~~b~~~~~~~~~bb~~~b~~b~b~b~~~~~bbb~~~~~~~bb~~~~b~b~~bbbb~bb~b~~~~~~~~~~~~b~b~b~bb~b~~~~~
~~~~~~~~~~~b~~~b~~~~~~~~b~~~b~~~~~~~~~b~~b~~~~~~~~bbb~~b~~~~bb~~~b~~bb~~~~b~~~~~~~~~~b~~b~~~~~~~~b~~~
~~~~~~~~~~~~~b~~~~bb~~~~~~~~b~~bbb~~~~b~~~~~~~~~~bb~~~~b~~b~~~~~~~bb~~b~~~~~~~~~~b~b~~b~~~~~~~b~b~~~~
~~~~~bbb~~b~~~~~~~~~b~b~b~~~~~~~~b~bb~b~~~~~~~~~b~~~~~~bbbbbb~bb~~~b~b~~bbbb~bb~~bbb~~bb~b~b~~b~b~~~~
~bbb~~~~~~~b~b~~b~b~bb~~~b~~~~~~~~~~~~~bb~bb~~~~~~~~~~~~~~bb~~bbb~b~~~~~bb~~~~~~b~~~b~~~~~~~b~~bb~~~b
~~b~~~bbb~~~b~~~~b~bb~~b~~~b~b~~~b~~~bb~bb~~~~b~bbb~~~b~~~~~~~~b~~~~~~~~~~~b~~~~~b~b~~~~~~b~b~~b~b~~~
b~b~~b~b~~~~~~~~b~~~~~~~~~bbb~~bb~~~b~b~~~~~~bbb~~b~~~~~b~~~~~~~~~~~~~~~~~~~~~~bb~~~~~~~~~~b~b~b~~bb~
~b~~~~~~~~~~~~~~~~~~~~~bb~~b~bb~bbbb~~bbb~~b~~~~~~~~b~~~~~bb~bbb~~~~bb~bb~b~~b~b~~~b~~~~~~~~~~~bb~~~~
~~~~~b~b~bb~~~~~~~~~~~~~bb~~b~~b~~~~~~b~~~~~~b~~~bb~~b~~bbb~~bb~b~~~~b~~~~b~~bb~~~b~~~~~~~~~~b~b~~~~~
~b~b~~~~~~bb~~~b~~~~b~~~~~~~~~~~bbb~~~~~~b~b~~~~b~~b~~~bbbb~~~~~~b~~~~~~bb~bb~~~b~~~~bb~~~b~~~b~~~b~~
b~b~~~~b~~~~~~bb~~~~~b~~~~~~b~~~b~~b~~~~b~~~~b~~~b~~~~~~b~bb~b~~~~~~~~b~~~b~~bb~bbb~bb~~b~b~~b~~~~~b~
~~~~~~~~~~~~bbb~b~~~~~~bbb~~~bb~~b~b~~~~~b~b~b~b~b~b~~~b~~b~~~bb~~~~b~~~~bb~b~b~bb~~b~~b~~~~~~~~~~~~~
~~~~b~~b~b~~~b~b~~~~b~~~~~~~~~bb~~~b~bb~b~~b~~bb~b~~~~~~~~~~bb~~~b~bb~b~b~~~b~b~~~~b~~bb~b~~~~~~bb~~~
b~~~~bb~~~~b~~~~~b~~b~~~~~~b~~~b~~~~b~~b~~~~~b~~~~~~~~~~~b~~~~~~bb~~~~~~~~~b~b~~b~~b~b~bb~~~~~~~~b~~~
~~~~b~~~~~b~b~~~~bb~~~~~~b~~~~~~~~b~~~~b~~b~~~~~~~bbb~~~~~bb~~~bb~~bbb~~b~~~~bb~bbbb~b~b~b~b~~~bb~~~~
b~~~~~~~~~b~~~~~~~b~~b~b~~~~b~b~bbb~b~~~~~~~bbb~~b~~~~~~~~b~~b~b~~~~~~~~b~~~~~~b~~bbb~b~~~~bb~b~~b~~~
~~~~b~~~b~~~~~~~~~~b~bb~~~bb~b~~~~~bb~b~~~bb~~~b~~b~~bbb~b~b~~~~b~~~~bb~b~~~b~~~bbbb~~~b~~~~b~bbb~~~~
~~~~~~~~~~~b~~~~bb~~bbbb~~b~~~~~b~~b~bb~~~b~~bb~~bb~~~bb~~~~~b~~bb~~~~~~~~~~~~~~~~~b~~~~b~~~~~b~~b~~~
bb~~~~~~~~~~b~~~~~~~~~~bb~b~b~~bb~~~~~~~~b~b~~bb~b~~bb~~~b~~~b~~~bb~b~b~bb~~~b~~~bb~b~bbb~bb~b~b~bb~b
b~~~~~b~~~~~bb~b~~~~~~~~b~~~~~~~b~~~~~bb~~~b~~~~~bb~b~~bb~~bbbbb~~~~~bb~b~~~~~~~bbbb~~b~~~bbb~~~b~~~~
~~~~b~~~b~~~~b~~b~bb~~~b~~~~~~~~~~b~~~~~~bbbbb~~b~bbb~~bbb~b~bbbb~~~b~~~b~~b~~b~~~~b~b~b~~b~~b~~~~b~~
b~~~b~~~b~~~b~b~~~b~~bb~~bb~~b~~bb~~b~~~b~~~~bb~b~b~~b~~~b~~~~~~~~b~b~~~~~b~bb~~bb~~~b~~~~bb~~~~b~~~b
~~~~b~~~~~b~~b~~bb~~~~bbb~~~~~~~bb~~~~~~~~~~~~~b~~~b~~bb~~bb~~~~b~~~bb~~~~~~~~~~~~b~~~b~~~b~~b~b~b~~b
~bb~b~~~~~~~~~~~b~~b~~b~~b~~~~~~~~~b~b~b~~~b~~~~~b~~b~~~~b~~~~b~~~b~~~b~bbb~b~~~b~~~~~b~b~~~b~b~~~~~b
b~~~~b~~b~~~~~~~~~~~~~~~~~b~~~~~~~~b~b~~~bbb~~~~b~b~~~~bbbb~~~~~~~~b~~~~~~~~~~b~~b~~~~bbb~~~~~~b~~~b~
~~b~bb~~~b~~~~~~~bb~~~~~b~~~~b~~~~~~~~bb~~~b~~~~bbb~b~~~~~~~bbbbbb~~b~bb~~~~~~b~b~b~~~b~~~b~~~b~~~~~~
bbb~b~b~~bb~~bbb~bb~~~b~~b~b~~~b~~b~~~~b~~~~b~~b~~~~~b~~~b~~bb~~~~~~~~~b~b~~bb~~~~~b~bb~bbb~b~~b~b~~~
~~~~bbb~~~~~~~~~~~~~bb~~~b~~~~~~~~~~~b~bb~~~~~bbb~~~~~~~bb~~~b~b~~bb~~~~~~~b~~~~~b~~~b~~~~~b~~b~bb~~~
bb~~~~~b~~~~b~bb~~~~~~~~~~~b~b~~~~~b~bb~~~b~~b~~~bbb~~b~~b~~b~b~~~b~~~~~~b~~bb~~~bb~~~~~~b~b~~b~~bbb~
~~~~~~~~bb~b~Gbbb~~b~~b~~~~~~~~~~b~~~~~b~~b~~b~b~~~~~~~b~~b~bb~bb~~~bbb~b~~~~~~~~~b~~~bbb~~b~~~~~bb~~
~~~bb~~~b~b~~~bb~~~b~~b~~~~~~b~b~bb~~~b~~b~b~~bbbbb~~~~~~~~b~~~b~b~~~~~bb~bbb~~~~b~~~bb~b~b~b~b~~~~bb
bb~~~~~bbbb~~~~~bbb~~~b~~~~~bb~~bb~~b~~b~~b~~~b~bbb~b~~~~~bb~bb~~~~~~~~~~b~~bbb~~b~~bb~~~~b~~~~~~~~b~
~~~b~~~~~~bb~~~~~~bb~bb~~~~~~~bbbb~~~~~~bb~b~b~~~b~~~~~bbbb~b~~~~~~~~~b~~b~~~~~~~~~~bb~~~~~~~~~~~~b~b
~~~bb~~~~~~~b~bb~~~~b~~~~b~b~~~~~bb~~b~~~~~b~b~~~b~~~b~~~~bb~~bbb~b~~~~b~~~~~~bb~~~b~~~~bb~~b~b~~~~~b
b~~~~b~~~b~~~b~~b~~~b~b~~~~~~~~~~~b~b~~~b~~~b~~~~~~~~b~b~~~~b~b~~~b~~~bb~b~~~~~~bb~b~~b~b~bb~~b~b~~~~
~~~~b~~~~~~~~~~~~~~~~~~~b~~~b~~~~~b~~~b~~~~b~b~b~~~~~~~~~~b~b~~~~b~~~b~~~b~~~~~~b~b~b~~~~~~~b~bb~~b~~
b~~bb~~b~~~~~~b~~b~~~b~~b~~~~~~~~~~~~~b~~~~~~~~b~~~~~~bbb~b~bb~~b~~~~~b~~~~~b~~~~bb~bb~~~~b~~~~b~~b~~
~b~~~bb~b~~~~b~b~~~bb~~~~~b~~b~~~bb~~~~~b~b~~~b~~~~b~b~~b~~~~~~b~b~~~b~~b~bb~~~~bb~~~~~~b~~~bb~~b~b~~
~~b~~b~b~~~~~~~~~~~~~~b~~~~b~bb~~b~b~~b~~~~~bb~~~~b~~~~b~b~b~~b~~~~~~~~~~~b~~~~~~bb~~~~~~~~~~~~~~bbb~
bb~~b~~~~~b~~b~~~~b~bbb~~b~b~~b~bb~~~~b~~~~~~~~~~~bb~~bbb~b~~~~~~~~~~b~~~~b~~~~~~~b~~~b~~~~~~~b~~~~~~
~~~~bbb~~b~~~~~~~~~~~~b~~~~~~b~~~~~~~~~~~b~~b~bb~~~b~bbb~b~~~~~~~~bbb~bb~bb~b~~bb~~b~~~~b~b~~~~~bb~b~
~bb~~~bb~~~b~~~~b~~~~b~bb~~bbb~~~b~~b~~~~b~~~~~~~~bb~~b~~b~~~~~~~~bb~~~~~~~~~~b~~~bb~~~~b~~b~~bb~b~~~
~~~b~~~bb~b~~~b~~b~bb~b~~~b~~bb~~b~b~~~~~b~~~~~b~~~~~~~~~~~~~~~b~~~b~b~bb~~~~~~~~~~b~~b~~~~~~~~~~~bbb
~~b~~~~b~b~bb~~bbb~bbb~~~~~~~~~~~~~~~b~~~~bb~b~~bbbb~~b~~b~~~~~b~~~~~~~b~~~~~~~~b~b~b~~~b~~~~~~~~~~b~
~bb~~bbb~~~~b~~~~~~~bb~~~~b~b~~~b~~~~~~b~~~b~b~~~~~~~~~~~~~~~~b~~~b~~~~bb~~~b~~~b~~~~~bbbbb~bb~~~b~~~
b~~b~~~~b~~b~b~~~b~bbbb~~bb~~~~~~b~~b~~~~~~~bb~b~~~~~~~~bbb~b~~~~b~~~b~bb~bb~~~~~~~~~~b~~~~~~~~~b~~b~
~~b~~b~bb~b~~b~b~~b~b~~b~bbb~~~~b~~~bb~b~~~~~bb~b~~b~~~~~~~bb~~b~~~b~~~~bb~b~~~~~~~bbb~b~b~~b~~~~b~b~
~~~~~~bb~bb~bb~~b~~~~b~~~~~bbb~~~~~~~~~~~~~bb~b~~~~b~~b~~b~~~~~~b~~~~~~b~b~b~~~~bb~~~~~~~b~~~bb~~~~~~
~bb~~~bbb~~~~~~bb~~b~~~~bb~~~~~b~~~~bb~~b~~~~b~bb~~bbb~~b~~~~b~b~~~b~~b~b~b~~~~bbbb~b~~b~~~~~~b~~~~~b
~~~~~~bbb~~~~~~~~~~~~~~~~~b~bb~~~~bb~~~~~~b~b~b~b~~b~b~~~~~~~b~bb~~b~bb~~~~b~~~~~~~~b~~b~b~~~~~~~~~~~
~~~~~b~b~~bb~~~~~bb~~~~~~~bb~~b~~b~~~~~~~~b~~bb~bb~~~~b~b~~~~~~~~~~~bb~~~b~~~b~~b~~~~b~~b~bb~~~~~~~~~
~b~~~~b~~b~b~~bb~bb~~b~~bb~b~~bb~~~~b~~b~b~~~b~~~~~b~~~~b~bbb~~~bbbb~~~~bb~b~b~b~bb~b~~~b~~~bbb~~b~b~
bb~~~b~~~b~bbb~b~~~b~bb~~~~~b~~~~~~~~~bb~~~~bb~~~~b~~~~~b~~b~b~~~b~b~~~~~bbb~~bbbb~b~~bb~~b~~~~~b~b~b
~~b~~~~~b~~bb~~~bb~~~bb~b~bb~~b~~~~~~~b~b~~b~bbb~b~b~bbb~~~b~~b~b~~b~~~~~bb~~bb~~~~~~~~~~~b~~~~b~~~bb
b~~~~~~bbb~~~~b~b~~~b~b~b~~bbb~b~b~b~b~bbb~b~~~~~bb~b~~~~b~~~b~~~~bb~b~b~b~~~~~~~~b~bb~~~~b~b~~~~bb~~
b~~~~b~~bb~~~~~~~~bbb~~~bb~~~~~~b~b~b~~bbb~~~bb~~~~bbbb~b~~b~~~~~~~~~~b~~~~bb~b~~b~~~b~~~~b~b~~bbb~~~
~b~~~b~~~b~~~b~~~b~~~~b~b~~~b~~~~~~~~b~b~~~~b~b~~~~b~~~b~~b~~~~bbb~b~b~~~b~~~~~~bb~~~~~bb~~bb~~~b~bb~
~b~~~~b~~~bbb~~~~~bbb~~~~~~~~~~~b~~b~b~bb~~~~~~~~b~~b~~~~~~b~~~bbb~~~bb~b~~~b~b~~~~~~~~~~b~~~~b~~~b~~
~b~b~~~b~~~~~~~~~~~~bb~~~b~b~~b~~~~~~b~~~b~~~~b~~~~~~~~~~~~b~b~~~~~~~~~bb~~~~~~~~b~~~~b~bb~~~~~bb~~~~
~~~~~~~~~b~b~~~b~b~~~~~b~~~~~~~~~~b~bb~bbb~b~b~~b~bbbb~~~~~~b~~~bbb~~~~b~~~~~~b~bb~bb~~b~~b~~~~~~~~~b
bbb~b~~b~~~~bb~~~~~~~b~b~~~~~b~b~b~~~bbb~~~~~~~b~~b~~b~~~b~~~~b~~~b~b~~~b~~bbb~~~~b~b~~~~~~b~~~~~~~~b
~bb~~~b~bb~~~b~~~~~b~~b~~~~~b~~~~~~~~~~b~b~b~~~b~~~~b~~~~bb~~b~~b~~~b~b~~~~~b~~~~~~b~~~b~~~~~bbb~~~bb
bbb~~~~b~~b~~~~~~b~~b~~~~b~~~~~~bb~b~b~bbbbb~~~~~~~~~~~b~~b~~~~~b~~bb~~~bb~~~~~~~~bbbb~~~b~~~~b~b~b~~
~~~b~b~~b~bb~~~~~b~~~~~~b~bb~~~b~~bb~~~~b~bbb~~~~~b~~~~~~~~~~~~bb~~~~~~~bb~~~~b~~~~b~~~~b~b~~~b~~~~b~
~~bbb~~bbb~b~b~~~~~b~~bbb~b~b~~~~~~~~~~~~b~~bb~b~~b~~~~~~~bb~~bb~~~~b~~~~b~~~b~~bbb~~~~~b~~~b~~~~~bb~
~b~~bbb~~~~b~~~~~bb~~~~~~b~~b~b~~~~~~~~~b~~~~b~~bb~~~b~b~~~~~~~~bb~~~bbb~~~b~~~~~~~~b~~~~~~~~~~~~bb~b
~~b~~~~~~~~~~~bbb~~~~b~bb~~b~b~b~~~~~~b~~b~~~~~~~~~~~~~~~~~~~~~~~~~~~~~~b~~~b~b~~~~~b~~~b~~~bb~~~~~~~
b~~b~~~~~~~b~~~~b~~~~~~~~~~~~~~b~~~b~~b~b~~~~~~~~~~bb~b~~~~b~~~~b~~bbb~bb~~~~~~b~~bbb~~~~~~~~~b~~bb~b
~~~~~~~~bbb~~~~~~~b~~b~~~~~~~b~b~~~~~b~bb~~~~bb~~~~~~~~~~~~bb~~b~~~~~b~~~bbb~~~~~b~~~~~b~~~~~b~b~~~bb
~~~~b~~~~b~~~~~~b~~b~~~b~~b~bbb~b~b~bb~~~b~~~b~~~~~bb~~b~b~~~~~b~b~b~b~~~~~~~b~~~~b~bb~bb~~~~b~~~~~bb
~~~b~b~b~~~bb~~~bb~b~~~~~bb~~b~~~b~~~~~~~b~b~~b~bb~~b~~~~b~~~~~~~b~b~bb~~b~bb~~~b~~~~b~bb~b~~b~b~bb~~
~~~b~~~bbb~~~b~~~~~b~~b~~~~b~~~b~~bb~bbb~~~bb~~~~bb~~b~~~~~~~~~~~~bb~~~~~~~~~~~~~~~~~~~~~~~~~~bb~~~~~
~b~~~~b~~~b~~~~~b~~~b~~bb~~bbb~b~~~~~~~~~~b~~~bbb~~bb~~~b~bb~~~~~~bb~b~~~~~~b~~~~~~~~~~bbbb~b~b~~~bb~
~~~~~~~~b~b~~~bb~~~~b~~~~~~bb~b~~~~b~~~~~~~~b~~bb~b~~~b~b~~~~~b~~bb~~~~~~~~~~bb~~bb~~b~~~~b~~bb~~~~b~
~b~~~~~~b~~b~~~~~~~~~~~b~~~~~~~~~~~~~~~~bb~~~bb~~~~~~~~b~b~b~b~~~~b~~~b~~~~~~~b~b~bb~~~b~~~~~~~~~~~~b
~bb~~b~~~~~~b~~~~~bbbb~~~~~~b~~~~~b~~~~~~bb~~~~b~~~b~~bb~b~b~~b~~b~b~~~~~b~~b~~~~b~~~~~~~b~~~~~~~b~~~
~b~~~~bb~b~bb~b~b~~~~b~~b~b~bb~~~~~~b~b~bbb~~b~b~bb~~~~~~~~~~~b~~b~~bb~~~bb~b~~bb~b~b~~~bb~~b~~~~~bb~
~~bbbb~b~bb~~~~~~~bb~bb~b~b~~~~~~~bb~~bb~b~~~~~~~~~~~~~~~b~~~b~~~~~b~bb~~~~~bb~b~~~~~~bb~~~~~b~~~~~bb
~~b~b~~~~bb~b~~~~~b~bbb~~~b~~bb~~~bb~~~~bb~~~b~b~b~~~~~~~~~~~~~~~~b~~~~b~~~~b~~~~b~~~~~b~~~~~~~~b~~~~
~b~~~~~~~bb~~~~b~~~~~~~~~bb~~~~~~~~bb~~~~~bb~~~~~~~b~b~b~~b~~~~~bb~~~b~~~~b~~~~b~~~~b~~bbb~~~b~bbbb~~
b~b~~~~b~~~~~~b~~~~~~~bb~~~~~~~b~~b~b~~~b~bb~~~~~b~b~~~b~~~b~b~b~~~~~bb~~~b~b~b~b~~~b~~~b~~~~~~~~b~~~
