~b~b~b~~~~~~~bb~b~b~~b~~~b~b~~~bb~b~~b~~~~~b~~~b~b~~b~~~~~~bbb~~b~~~b~~~b~b~~~b~~~~bb~b~bb~~~~~~~~~b~
~b~b~b~b~~bb~~~~~~~~~~~~b~~~~~~~~~~b~bb~~~~~~~~~~~b~~b~b~~bbb~bbb~~~~~b~~~~~~~~~~~~b~b~b~~~b~~b~~~~bb
~b~~~~~~~~~~b~~~~b~b~bb~bb~~~~~~~b~~~~b~~~~bbb~~b~b~~~bbb~bb~~~~~~b~~b~~~~~~~~~~~~~~~~~~b~bbb~b~b~~b~
~~b~bb~~~~~~~bb~~~~~~~~~~~bb~~~~b~~~~b~~~~~~~~~b~~~~~b~~~~~bb~~~~~~~bb~b~~~~~~~~~~~~~~~b~~~~~~~bb~~bb
b~b~bb~~~b~~~b~b~bbb~b~b~~bb~b~~~~bb~~~~b~~~~~~b~~~b~~b~~~~~~~~~~~b~~b~~~bb~b~~b~b~b~~b~b~~~~~b~b~~bb
~~bb~bb~~~~b~~~b~~~b~bb~~~b~b~~~~~~~~~~~~~b~b~~~b~b~~~~b~~~b~bb~~~~~~~~~bbb~b~~~~~b~bbb~~b~~~~~b~b~~~
b~b~b~~~~b~b~~~~~bbbb~~~~~~~~b~~~~~bb~~~~~~~b~~~bbbb~b~~~~~~~~~b~~b~~~~~~~~~~~b~b~~~~~b~~b~~~~~b~b~~b
~~~~~b~~~~b~~~b~~~b~~~~~bb~~b~~~~b~~b~b~b~~~~b~~b~~~bb~~~~~b~b~~b~~bb~~b~bbb~~bbbb~bb~~~~~b~~~b~~bb~~
~~b~b~~bbbb~b~~~~~b~~~bbb~~~~b~b~~~~~~bb~~~~b~~~bb~~b~~bb~~~~~b~~bbb~~~~~b~~~~~~~b~~~~b~~~b~~b~bb~~~b
~b~~~~~b~bb~b~~~~b~~~~~b~~b~bb~~~b~~~~~b~~~~~bb~~b~b~~bb~b~b~~bbb~b~~~~~~b~bbb~b~~b~~~b~~~b~bb~~~~b~~
~b~~b~bb~~~b~~bb~~b~~~~~bb~~~~bb~~~~bb~~~bb~bb~~~~~~~~~~~~~~~~~~~bb~~~~~~~bbb~b~bbb~b~~b~b~~~~~bb~~~b
~~~~b~~~~~~~~b~~~~~b~~~b~b~~~bb~b~~~~~~b~~~bbb~b~~~~~~b~~~~~~~~~~~~~~~~b~b~~~bb~~~~b~~~b~b~~b~b~~~~~~
bbb~~b~~bb~~~~~~~~b~~~b~b~~~~b~b~b~~~~~~~~~~bb~~b~~b~~~~~~b~~~~~~b~~bb~bbb~~~~~b~bb~b~~~~~~b~~~bb~~~b
~~~~~bb~~bbbb~~~b~~b~~~~~~~~~~~~~~~~~b~~b~b~~b~~~b~bb~b~~~b~~~b~bbb~~b~b~~~b~~bbb~~~~~~~~~~~b~~~~~~~b
~~~~~~b~~bb~~~~~~~b~~~b~~~~b~~~~~~bb~~~~~~~~~~~bb~b~~bb~bbbb~b~~~b~~~~~~~bb~~~~~~~~b~b~bb~~b~~~~~~~~b
bb~~bb~~~b~~b~~b~~b~~~~~~~b~~~~bb~b~~~~~~b~b~~~~bbbb~~~b~b~~~~~bbbb~~~b~~~~b~~~~b~b~~~bb~~b~~bb~~~~~~
~~~~b~~~~~~~bbb~~~~~~~b~~~~b~b~~b~~b~~b~~b~~~b~~~~bbb~b~~b~~~bb~~bbb~b~~~~~~~~~b~~bbb~~~~~~~b~b~~~~~~
bb~~~~~b~b~~~bb~b~~~~~~b~~~~~~~b~~~~b~~b~~~bb~b~~b~bb~~~~b~~~bb~~~~~b~b~~~~~~~~~~~~~~b~~b~~~~~~bb~~~~
b~bb~bb~b~bb~~~~~~~b~~~b~b~~bb~~~~~~b~~~bb~~~bb~~b~~~bb~~~~bbb~~b~~~~bb~~b~~~~bb~~~~~b~~bb~~b~~~~~~~b
~~~~~~bbb~~~~b~~~~bb~~~~b~~b~~~~b~~b~~~~~b~~b~~~b~b~b~b~~~bbb~~b~~~~~~~bb~b~b~bb~~~~b~~b~~~b~~~~~~~~~
b~b~~~~~~~~~~~~~~b~~b~~~~~~b~b~~~~~~b~~~~~bbbbb~b~~~~b~~~b~~bb~~b~~~~b~bbb~~~~~bb~~~~b~~~~~~b~~~b~~~~
~bb~~~~~~~~~bbb~~~~~~~bb~~~~bbb~b~~~b~~~bb~~~~b~~~~bb~b~b~~b~bb~~b~b~~~~~~~b~bbb~~~b~b~b~~~~~~b~~~b~~
~b~b~~~~~~~~b~~~bb~b~b~~~~~~b~~~b~bb~~b~bb~~~~~~~~~~~bbb~~~b~~~~b~~~b~~~bb~~~b~b~b~bbbb~~~~b~b~bb~~~~
b~~b~~~b~~~bb~~b~b~~b~bb~b~~~~~bb~b~~~~bbb~~b~~~~b~~~~~~~b~~~~~~~~~bbbb~b~~bb~b~bb~~~~bb~~bbb~~~~~~~~
b~~b~~~~~b~b~~~~b~~~~~bbb~bbb~~b~b~~~~~~~~b~b~~b~~b~~b~~bb~~~~~~~~~bb~~~~~b~~~~bb~~~b~bbb~~b~~~b~~~~b
b~~~bb~b~~~~b~~b~~~~~~~~~b~~~~b~b~~~~~~bbb~~~~b~~~~~~~~~~~~~~~~~bbb~~~~~bb~bb~bb~b~~~~bSb~~~b~~b~b~~~
b~~b~~~b~~b~~~~bb~~~~~~~~~~~b~~~~~~~~b~~~~~~b~~~~~b~b~~~b~~~~~~b~~~~~~~~~~~~bbbb~~b~b~b~~~~~~~~~~~~~~
b~~~~~~~~~b~~b~~bb~~~~~~~b~b~bbb~~~~b~b~~~~bbb~~~~~~~~~~~~~~b~~~~~b~~~bbb~~~~b~~~bb~~~bbbbb~b~b~~~~~~
~~b~b~~~~~~~~~b~~~~~b~~~~~bb~~~b~~~~~~~~~b~~~~~~~~~~~~~b~b~~~~~~~~~~b~~~~~~~~~~~b~~~~~~~b~b~b~b~b~~~b
~~~b~~~~~~b~~b~b~~~b~b~~~~b~~bb~~~~~~~b~~~~b~~b~bb~b~bb~~~~~~~~b~~~b~~~~~~~~~b~bb~~b~~b~b~b~b~~~~~~~b
b~~b~~~b~~~~bb~~b~~b~~~~~~~~~~~~~b~~~b~~~b~~~~~~~~b~~b~~~bb~~b~~b~~~~~~b~bbbb~~~~~~~~~~~~bb~~~b~~~b~~
b~b~~b~~bb~~~~~b~~b~~~~~bbbb~~~~b~~b~b~~b~b~~~bb~~~~b~bb~~bb~~~~b~~~bb~~~~bb~~~~b~bb~~~bbbb~~b~~b~~~~
b~~~b~~~~~~~~b~~~~~~b~b~~bbb~~~~~~~b~bbbbb~~~~~bb~b~~~~~~~~b~~~~~~~~~b~b~~bbb~b~~~~bb~~~bb~bbb~~~b~~~
bb~~~~~b~bb~~~~~~~~~~bbb~~~~b~~b~~~~~~~bb~~~~b~bb~~~b~~b~~~~~bbb~~~~~~~~~~~~~~~~~~b~b~~b~b~bbbb~~~bb~
b~~~b~b~~~b~~~~~~bb~~~~~~~~~b~b~~~~~~b~b~~~bb~b~~~b~~~~~bb~b~b~~~~b~~~~~~~b~b~~~~bbb~~~~bb~b~~b~~~~~~
~~b~~~b~~~~~~~b~~b~bbbb~bb~~~~~~bbb~b~~~b~~~~b~bb~b~bbb~~~bbb~~~bbb~~b~~~~~~~bb~~b~~~bb~~~~bb~bb~~~~~
~~~~~~~b~~~~~~b~~~~bbb~~b~b~bbb~~~~~~~~~~~~b~~~bbbbb~bb~b~bb~bbb~b~b~~~b~~~~b~b~~~~~~~~~~~~~b~~~~~~b~
~b~~~~~~~~~b~b~~~~~~~~~b~~~~b~~~b~b~~~~~~~~b~~b~bb~~~b~~b~~b~~~~b~~~~~bbbb~b~~~~~~b~b~~~~~~bb~~~~~b~b
~~~~b~b~~~bb~~~~~~~~~~b~~~b~~~~~~~~~~b~b~~b~bb~~bb~~~b~~b~b~~~b~~~~~~~bbb~bb~~~~~~bb~~b~b~~~b~~~~~~~b
~~b~~~~~~b~~bb~~bb~~~~~b~~~~~~~~bb~~b~~~b~b~~~b~b~bb~~~~~~b~~b~~~bb~~b~~bbb~~~bb~~~~~~b~~~b~bb~~b~~~~
~~~~b~~~b~~~~~b~~b~~~~~~bb~~~~b~~~~~~b~~~~~~~~~~~~b~~~~~bb~~~~~~~~~~~b~~b~b~~b~~~bbbb~b~b~~~~b~~bb~bb
b~~~~~~b~bb~~b~~b~~~~~~b~bb~~b~~b~~b~~~bbb~~~~b~~b~~~~~~~bbb~b~~~bb~b~~b~bbb~~~~~~~~~~~b~bbb~~~~~~~~~
~~~~~~~b~~~~~~bbb~b~~~~bbbb~~~~~~~b~~~~b~~~~~~bb~~bb~~~b~~b~bb~b~~~~~b~~~~~b~~~~~~~~b~b~~bbb~~~b~~~b~
~~~~b~b~~~~b~~~~~~~b~~~b~~~~~~b~~b~~b~~~~b~~b~bb~b~b~~b~~~b~~bbbbb~~b~~b~~~~~b~~b~~~~b~~~~b~~b~b~~~~b
~~~~~~~~~b~~~~~~~b~b~~b~~b~b~b~~~~~~~b~~~~b~~~~~bbb~~~~~~b~~~b~~~~bb~~~~~~~~~b~b~~~b~~~~~~~~b~b~~~~~~
~bb~~~bb~~~~~bb~~~b~~~~~~~b~~~~bbbb~~~~~~b~~b~~~~~~~~~~~~b~b~~~~~~~~~b~~~~~~~~~b~~~b~~~~b~~bb~b~~bb~b
~~~~b~~~b~b~~~~~bb~~b~~b~~~b~bb~~b~~~~b~~~~~~~~~~~~~~~b~b~~~~b~~~b~~~~~~~~~~~~~~b~b~b~~~b~~~~~~~~~~~~
~~~~~~b~b~b~~~~~~~~b~~~~~bb~~bbbb~~~~b~~b~~~~~~~~~b~~~~~~~~~~~bbbb~~~~~~bbbbb~bb~b~~~~bb~~~~b~~~~~~~~
bb~~~~~bbb~~bb~~b~~~~~~~~~~~~~b~~b~~~~b~~b~b~b~b~~~~~b~bb~bb~~bbb~~b~~~b~b~~~~b~~~~b~b~b~~~~~b~~~b~~~
b~b~~~bb~~~b~~bb~~b~~~~~bb~~bb~b~~~~~~b~~~~~~b~~~~~~b~b~~b~~~~~~bb~~b~b~~b~~~~~~~~~~b~~~~b~~~~~~~~~~~
~~~~~b~~bbbb~b~~~~~~~~~~b~b~~~b~~~~~~~~b~~~~~~~b~~~~bbb~~~~b~b~~b~b~~b~~~~~~~~~~~~~~~~~~~~~~~~~~~~~~~
~~~b~~~~~~~~~b~~~b~b~bbb~bb~~~b~~bb~~~bb~~b~~~~~~~~~~b~~b~~~b~~~~~~~~bb~~~~bb~~~~~~~~~~~~bb~b~~~~~~~~
b~~b~~b~~bb~~~~~~~~~bb~~bb~b~~~~~~~bb~~b~~~~~~bb~bb~bb~bb~~bb~~~b~~bb~bb~~~b~~b~~~b~~~b~b~b~~~~~bb~b~
b~bb~~~~~~b~~~~bb~b~~bb~~bb~~~~b~~~~~~~b~~b~~~~bb~~bbb~~~b~~~~b~b~b~~b~~~~b~~bb~bb~~b~b~bb~~~~b~~bb~~
bb~b~~b~b~bb~~bbb~~~b~b~~~bb~~~~~~~b~bb~~~b~b~~~~~b~~~~~b~b~bb~~~~~~~~bbb~b~~bb~~b~bb~bb~~~~~~~~~~~~b
bb~~bbb~~~~b~b~~~~~~~b~~~~~~~~~~~~~~b~~bbb~~~~~~~~bbb~~b~~~~~~b~~b~bb~~~~~~b~bb~b~~~b~b~~b~~~~~b~~~~~
b~~b~~~~b~~~~~b~~~~b~~b~~~~~~~bb~~~~b~~b~~~~~b~G~~b~~~~~~~~~~bbbb~~~bb~~~~~b~~~~b~~bbb~~~b~~~b~~~b~bb
~~bbbbbbbb~~~~~~~~~b~~~~~~~~~~~~~b~~~~~b~~~~~~~~~~~~~~~~b~~~~~~~~~~~~b~b~~~b~~~~~~bb~~b~b~~~~~b~~b~~~
~~~bb~~~~bb~~~~~b~~bb~~~~~b~~b~~~~~b~b~bbbbb~~b~~~~b~~b~~~b~~~b~bb~~~~~~~~~~~~~~~~~~b~~b~bb~bbb~bb~~~
b~b~~~~~~~~~b~bb~~~~~~b~~bb~bb~b~~b~~~~~~b~b~~~~~b~b~b~~b~~bbbbb~~~b~b~bb~b~~bb~bb~~~b~~~bb~~~~~~~~~b
~b~~b~~~bb~~~~~~bb~b~b~~b~~~~~~~bb~bb~b~~~bb~~~b~~~~~b~~b~b~~b~b~~~~b~bbb~~~~bb~~~~~b~~~~~~b~b~~b~~~b
bb~~~~~~b~bb~b~~b~bb~~bb~~b~b~b~~~~b~bb~~~~~~~~b~~b~~b~b~~~~~bb~~~b~~~b~b~~~b~~~~b~b~~~~bbb~~~~~bbb~b
~~bb~~~~~~b~b~~~bbbbb~b~~~~~~bbb~~b~b~~~~bb~~~bb~b~~~b~~~~~~~b~b~b~~b~b~b~bb~b~b~~~~b~~~~~~~~b~~~~~~~
b~bb~~~~~~~~~~~~~~~~~~~b~~~~~~~~~b~~b~~~~~~b~~b~~bb~~~~~b~~bb~b~~~~b~b~b~b~~~~~~bb~~~b~~b~~~~b~~~bb~~
~~~~bb~~~~b~~b~~~~~~~~~b~bb~~~~~~~~~~~~~~~b~~~bb~bb~b~~b~~~bbb~b~bbb~~~b~~b~~~b~bbb~~~~~~~b~~~~~b~~~~
~b~~~~bb~~~~~b~~bb~~~bb~~~~~~~~~~~~b~~~~~~~bb~~b~~b~~~b~~~b~~~bb~~~b~~b~~~b~~~bb~~~~~~~~~b~~bb~~~~bb~
~~~~~bb~~~~~~~~b~~~~~~~~~~~b~~~~b~~~~~~~~~b~~~~~~b~~~~b~~b~b~b~~bb~~~~~~bb~bb~~~~~~b~~bb~~~b~~~~~bb~~
~bbb~b~bb~~~~~b~~bb~~~b~~~~~~~~bbb~~~~~~~~~~b~bbb~~~b~bb~~~~bb~~~~~b~~~~~~~~~bb~b~~b~b~~~~~b~~~~~~~~b
bb~~bb~~~~~b~~b~~~bbb~~~bb~b~~~~~~~~~~~~~~b~~~b~~~~b~b~b~~b~~~~~~~~bbb~b~b~b~~~~b~~~~~~~bb~b~~~~~~b~b
~~~~~~b~~bbb~~~~~b~~~b~~~~~~~~bb~~~~~~~b~~~b~~~bb~~~bbb~b~~~b~~~~~~~~~~b~~~bb~~~b~~~b~~bbb~~~~~~~~~~~
~~~~~~b~~~~bb~~~~bb~~~~b~~b~~~~b~~~~~~bbb~~~~bb~bbb~b~~~~bb~~b~~~~~b~~~b~b~~~bb~bb~bb~~bb~b~~~b~~~~~b
~~~~~~~~~~~~~~b~~~~b~b~bb~~~~~~~~~~~~b~~~~~~~~~b~~~~~~b~~~b~~~bb~~~~~bbbb~~~~~b~~~~b~~~~~~~bb~~b~b~~~
~b~~~b~~~b~~~b~b~~b~~bb~~bb~~~~~~~~~~~b~b~~b~~b~~~b~~~b~~bb~~~~~b~~b~~~~~~bb~~~~~b~~bbbb~~~b~~~~bb~~~
~~~bb~b~~b~~b~~~b~~~~~b~~bbbb~~~~bb~~bbb~~~~~~~~~~~~b~~~b~~~~bb~~~~~~~b~~~~~bb~~b~~~b~~~~~~~~~~~~b~~b
~~~~~~~~~~b~b~~b~~bb~~b~~b~~b~~~~~~~b~b~~~~~~b~~~~~~~b~~~b~~~~bb~~b~~~bbbbb~~~~b~~~~b~b~b~b~bb~~~~~~~
b~~~~~b~b~~~b~~~b~~bb~~~~bbb~~~~b~~b~~~b~~b~b~~~~~~~~b~~~b~~~~~~b~~~bb~~~~~b~~~b~~bbb~b~~~~~~~bb~~~~b
~~~~~~~~~~~b~bbb~~~~~~~bb~b~b~~~~~~~b~~~~~b~~~b~~~~~~b~~~~~~bb~~~~~~~~~bb~~~b~bb~~~~bb~b~~~~b~bb~~~b~
~~~b~bb~~b~~b~~~b~~~~~b~b~b~b~~b~~~bb~~b~~~bb~~~~~~~~~b~bb~~~~~~bb~~~~~b~~~bbb~~b~~b~~~~~~~~~b~~b~b~b
~~~b~b~~~~~~~~b~~~~~b~~b~~b~~~~~~b~b~~~~~~b~~~bb~bb~~b~bb~~bbb~~bb~~b~b~~~~~b~~b~b~bb~b~~~~~~~~b~~~~~
~~~b~b~b~~~~~~~~~bb~~~b~~~~~~~~b~~~~b~~~bb~~~~~b~~~~~b~~~b~~bbb~~b~~b~~b~~~~b~b~~~~bb~~bb~~~~~~bb~b~~
b~~bb~~b~~b~~b~~~~~bb~~~~~~~~b~~~~~bb~~~~b~~~~~~~b~bb~~~~~b~~bb~~~~~~~b~~~~bb~~~~~~b~~b~b~~b~bb~~~~b~
~~~~~~b~b~bbb~~b~~~~~~~b~~~~~~~b~b~b~b~~~~b~~bb~~~~~~b~b~~~~b~~~~~~~~b~bb~~~~b~b~~bbb~~~b~~b~~~~~~~bb
~b~~~~~bb~b~~~bbb~~~bb~b~~~~~~b~~~b~~~b~~~~b~~~~~bb~b~~~~bb~~~~~b~b~~~bbb~bb~b~b~~b~~~~~b~bb~~~~~~~b~
b~~b~~~~~~b~~~~~~~~b~~~~b~~~~~~b~b~b~~~~~~b~~~b~bb~b~~~b~~~~~b~~b~~~b~~~~~~b~~~bbb~~~~~~~~~~bb~~~~~~~
b~b~b~~b~b~~~~~~b~~~~~bb~~~~~~~~~b~b~bbb~~b~b~bb~b~~~~~~b~~b~b~~~~~~~~~~b~~~b~b~~~b~~~~~b~~~b~b~~~~~~
~b~~~b~b~~bb~~b~b~bb~~~bb~b~~~~~~~~~~~~~~bb~~~b~~b~~b~bb~~~b~~~~~~~~b~~~b~~~~~~b~~bbb~b~~~~~~~b~bbb~~
bbb~~~~~~~b~~b~bb~~~b~~b~~~bb~~bbb~~~b~~~b~~~~~~~~~~b~~~~~~~~~~~b~~~~b~bb~~~~~bbb~~~~~~bb~~~bb~b~~~b~
~bb~~~~~~bb~bb~~b~~bb~b~~~~~~~~~~b~~bbbb~b~~~b~~b~~~~~~~~~~~~b~~~b~~~~~~~~~bb~~b~b~~~~b~b~~~~b~~b~~~b
bbbb~b~~~~~~~~~~bbb~~b~~~b~~~bb~b~~~~b~~bbb~~b~~~~~b~~~~~b~~~~b~~b~~b~bb~~~~~bb~bbbb~~~b~b~~~~b~b~~~~
b~b~b~~b~~bbbbb~b~~~~b~~~~bb~~b~~~~b~~~~~~~~b~~~b~b~b~~~b~~~b~~~~b~~b~~~bb~~~~b~~~b~b~~~~~~~b~~~b~~b~
~b~~~~~bb~~~~b~~bb~~b~b~~~~bbbb~b~~~b~~~b~~b~~~~~~~bb~~~~b~~~~~~~~b~~bb~~~~~bb~~b~~~~~~~~~~~b~~b~b~~~
b~b~~~~b~~~~bb~bb~~~~~b~~b~~~b~~b~b~~~~b~~~~~b~b~~~bb~~~~~b~~~~~~~b~~~~~~~~~b~b~~b~~b~b~~b~~b~~~~~b~~
b~b~~~~~~~~~~~~~b~~bb~~~~~b~~~~b~~b~b~~~bbb~b~bb~~b~~b~~~b~~b~b~bb~b~~bbbbbbb~~~~b~~~~b~~~bb~~~~~~~bb
b~~b~~b~bb~b~b~b~b~b~b~~~~~~b~~bb~~~bbb~~~~~b~~~~~~b~bb~~bb~~~b~~b~~b~~~b~~~b~~~~~~~~~~~bb~~~~~~~~~~b
~~~~b~b~bbb~b~~b~~~~~~bbbb~bbb~~~~~~~~~~~~~b~~~~b~~b~~~b~~b~~~b~bbb~~~~~b~~~~~bb~~~~b~~~~~~b~~b~~~bb~
~~~~~~~~~~~~b~~~~b~~~b~~bb~b~b~~~~~~~b~~~~~~b~~b~~~b~~~~~~~~~~~~~b~~~~~~~b~~b~~~~~~~~~~b~~~~b~b~~b~~b
~~~b~~~~~~~~b~b~~bb~~~~~b~~~~~~b~~bb~~b~b~b~~b~~~~~~~~~~~~b~~~~~~~~~b~~~~~~~bbb~~b~~~~~~~~~~b~~b~~bb~
b~~b~~~~~~~~~bbb~b~~~~~~~~~~b~~~~~b~~~~~~~b~~~bb~~~~~~~~~~~~b~~~b~~~~~b~~b~~bb~b~~~~~~~~bb~~~~~~~~b~~
b~~~~~~~~~~~~~~~~b~~b~~bb~b~b~~b~~b~~b~~~~~b~b~~~~b~b~b~b~~~~~b~bbb~~~~~b~b~b~~bb~~b~b~~~bb~~~~~~~~~~
~b~~~b~~b~~~b~~b~~~bb~~b~~~b~~b~b~b~~b~~~~b~b~~b~~~~~~bbbbb~~~~~~~~~bb~~~bb~~~~b~~~b~~~~bb~b~b~bbb~~~
~~b~~~~~b~~b~~~~~~~~~~~~~~~b~~~~b~~~b~~~b~b~~~~~~b~bb~~~~~~~~~bb~~~~~~~b~~b~~b~~~bb~~~~b~~~~b~~~~bb~b
