~~~~~~~bb~~bb~bbb~bbb~~~~~~~~bbb~~b~~~~~b~b~b~~~b~bb~~~~~~~~bb~~~b~~~~~b~~b~~~~bb~b~b~~b~bb~~b~~~~b~~
b~~~~b~b~~~bb~~~~b~b~~b~b~b~~~~~~~~~b~~~~~~~~~b~b~b~~~~~b~~~b~bbb~~b~~~~bb~~b~bb~~bbb~~~~~~bbb~~b~~~~
~b~~~bb~~~~b~~~b~b~~b~~~~~~~~~~b~~b~b~b~bb~b~bbb~~~~~~b~~~bb~~~~b~b~~~~~~b~~b~~b~~~~~~b~~~~b~~~~~~~bb
~b~~~b~~b~~~~~~~~bbbb~~~~~~~~~b~~~~b~~b~bb~b~~~~~~~bb~bb~b~b~~bb~b~~~bb~~~~~bb~~~~~b~b~~b~~b~b~~~~b~~
~~~bb~~~~~~bb~bbb~~~~~b~~~~~~~~b~b~~~b~~~b~bb~~~~b~~~bbb~b~~~~~~bbbbb~b~~~b~~~~~~~~~~~~~~~~~b~~~~bb~~
~~~~~b~~~b~~~~~~~~bb~~~~bb~~~~~b~~~b~~b~~~b~~~~~~~~~~~~~~~~~~b~~~~~~b~~~~~~b~~~b~~~b~~~~~b~~~~~~~b~b~
~~bbb~~~~~b~~~~~b~~b~~bb~b~~b~bb~b~~b~~~~~~~~~~~~b~~~~b~~b~~~~~bbb~~~b~~~~~~~bbb~b~~~~~~~~~~~bb~b~~~~
~b~~~~~~~bb~~bbb~bb~bbbbb~~b~~bbb~~~b~bb~~~b~b~~bbb~b~~~~b~~~~~~~~bb~~~b~~~~~~b~~bb~~~~~~~~b~~~~~~~~~
b~~~b~b~~~~~~bb~~~~~~~bb~b~b~~bb~~~b~~~~~~~b~~~~~~~b~~~~b~~bb~~b~~~~bb~bb~~~~~~~~~b~~~~~b~~~~b~b~b~~~
b~b~b~~~b~bbb~~~~b~~~~~~~~b~~~~~~~~bb~~~~bb~~b~b~~~~~b~~b~~b~~~~~~~~bbb~~~~b~~~bb~~~bbbb~~b~~bbb~~bbb
~~~~~~~bb~~~b~b~~~~~~~~~~~~~~~~bbb~b~~b~~bb~~~b~bb~~bbb~~~b~~~~~b~~b~~b~~~~~bb~~~b~~b~b~~b~~~~~~~b~b~
~~~~~b~~~b~~~~~~~~~~~~~b~~~b~~~~~~~b~b~b~b~~b~~~~b~~~~~~~~bb~~b~~~bb~~~~b~~b~~bb~b~b~b~bb~b~~~~~~~b~~
~~b~b~~~b~b~~~b~b~bb~~~~b~b~~~~~bb~~b~~~~~~~~~b~b~~~b~b~bb~~bb~~b~~b~~~~bb~b~~~~bbb~~~~~~~~~b~~~~~~~~
~~~~~~~b~~~~~bbb~b~~bb~~~~~~b~~bbb~bb~~~~~~b~b~~b~~~~~~~b~~~~b~~~bbb~~~~~~~~~~~b~~~~~~~~~~~b~b~~b~b~~
b~~b~~~b~~~~~~~~~~~~~b~~~~bb~~bb~~~b~~~~~~~~~~b~~bb~~~bbb~~~b~~b~~~~~~~b~b~~~~~~~~b~bb~~~~~~~b~~~~~bb
~bb~b~~~~~~~b~~b~~b~~~~~~b~b~~bbbb~~~~b~~b~~b~~~~b~~b~b~~b~~~~~b~~~~b~b~~~~~b~b~b~b~~~b~b~~bb~b~~~~b~
bb~~b~~~~b~~~~~~~~b~b~~~b~~~~b~b~b~~b~~~~~b~~bb~~~b~bb~~~~~~~~~b~~~b~b~~~b~b~~~~~~~~~b~bbb~~b~~b~b~~~
~~~b~~~~~~~b~~~~~~~b~~~~~~bb~~~~~~~bb~~bb~b~~~~~~~b~~b~b~~~~~~bbb~~~~~~~~b~~~bbb~b~b~bbbb~~~b~~b~~~~~
b~~~~~b~~b~~~bbbb~~~~~~~~~~b~b~~b~b~b~~b~~b~b~b~~~~b~~~~~~b~~bb~~bbbbb~bbb~b~bbb~~b~b~b~~bb~b~b~~~~b~
~bb~b~~b~b~~~~~bbb~bbbb~bb~~bbb~~~~b~~~b~~~~~~~~b~~~b~~bb~~~~~~~b~~~~~bb~~b~~b~~~~~~b~~b~~~~b~~~~~bb~
b~b~b~~~~~b~~~bb~~~~~~~~~b~~~~~~~~~~b~~~~~bb~~b~~~~b~~~~~~~~~b~~b~bb~~b~~b~~b~~~b~b~~~~~~b~~~~~~b~b~~
~~bbb~~~~~b~~bbb~~b~~~b~~b~bb~~~~~~~~~~~~b~~~~~~b~~b~~~~~b~~~~b~~~bbb~~~b~~bb~~~b~~~~~~b~~~~~~~~b~~b~
~~bb~~~~bb~~~~~b~~b~~b~~~~~b~~~~b~~~~~~~~b~~bbb~~b~~~~b~~~bb~~~~b~b~~bb~b~b~~~b~bbb~bb~~~~bbbbb~~~b~~
~~~bb~bb~~b~~b~~b~~~~bbb~bb~~b~~~b~~b~~~b~b~~~~~~~~~b~~~~~~b~~b~~~bbb~~b~b~~~b~~b~~~bbb~~~~~b~~b~~~b~
b~~~~b~~~~~~~b~~~~~~bb~~b~~~~~~b~b~~~b~b~~~~~b~~~~~bb~~b~~~~~b~~~bb~b~~b~b~~~~~~~~~~b~~~~bb~~~~b~~~~b
~~~~~~~~bb~~b~~~~~b~~b~b~~~~~b~~~~~~~~~~b~~b~~~~~~b~b~bb~~~b~~~~~~~~~~~~~b~bbb~~~~~~~~~~~b~~~~~~~~~~~
~b~~b~~~~b~~~~~~~~~~G~~~~~~~~bb~~~~~b~~~~~~~~~~bbbb~b~b~~~~~~b~~bb~~~~~~~~~~~~~b~b~~~b~~~b~~~~~b~b~~b
~~~~b~~~bb~~~b~b~~~~b~~~~~~~~bbb~~~b~~~~~bb~~~~b~~~~~~~~~bb~b~~~b~b~~b~~~~bb~~~~b~~~b~~~~bb~~~~~~~~~~
~~~~b~~b~~~~b~b~bbb~~~~~b~~bb~bb~~~b~~~~bb~~~b~b~~~~b~b~~~b~b~bb~~bb~~~~~~~~~b~~~~~~b~~~b~~b~~b~b~~~~
~bb~~~bbbb~~~b~~~~b~~~b~b~~~~~~~~~~~~~~~~~b~~b~b~b~~~b~~~~b~~~~b~~~~~~~~~bbbb~b~~~~~~b~b~~~~bbbb~bbbb
~~~~b~~b~~~~~~~~b~~~~~~b~~~~b~~b~~~~~~~~b~~~~~~~~~~~~~b~~~b~~b~~~~b~~~b~~bbbb~bb~~~~~~~bb~~~bb~b~b~~~
~bb~b~~b~~~b~~~~~~~b~b~~~b~~bb~~~~~~~b~~~~bb~~b~~~~bb~~~~~~bb~~~b~~~~~b~~~bbb~~~~~~b~~b~~b~~~~~~b~~~~
~~~~~~~~~bb~~~~~b~~~~~~~~b~b~~~~~~b~~~~~~bbb~~~~~b~~~b~bb~~~~~~~b~~~b~b~~~~~~~b~b~~~~~bb~~~b~~b~~~b~~
~~~bb~~~~~b~~~~bbb~~bbb~~~~~~~b~~~~b~bb~~~~~~~~~b~~b~~~~~b~~~b~~~~~~~~~~bb~~~~~~~~b~~~~~b~~~~b~~~~~~b
~~~~~b~bb~b~bb~~~bbb~~~~b~~~b~~~bb~~~~bbb~~~~bbb~b~~~~bb~~~~~~~~b~~~~~~~~~b~~~~~~~~~~~b~b~~~b~~~b~b~~
~~~~~~~b~~~~~~~~~~~b~~~~~~~~~~~~~~~b~~b~~~b~~b~~~~b~b~~~b~bb~b~b~~b~~~~~b~~bb~b~~~~~~~~~~~~~bbb~b~~~~
~b~b~~~~~~~~~~~bb~b~~~~b~~~b~b~~~~b~b~~~~b~~~~b~~bb~~~~~~~~~~b~~~b~~~~~~bb~~b~~bb~b~b~~b~bb~b~~~~~~b~
~~b~~~~b~b~~b~~~~~~~~bb~b~bb~~~~b~b~b~~~b~~~~~~bbbbbb~~~~b~b~b~b~~~~~bb~~~~~~~bb~b~~~bb~~~~~b~~~~~b~~
~b~b~~~b~~~~~b~~~~~~~~~~~bb~~~b~~~~~~~~~~~b~~~~~~~~b~~bb~~~~~~~~~bb~b~~b~~bb~b~~~~~~~b~bb~~~b~~~bb~~~
~~~~~b~b~b~~~b~bb~~bb~bbbb~bb~~~bb~~~~~~bbb~b~~~~~~~~~~~~b~b~b~~~b~~~~~bb~~b~~b~~~b~~bb~~~~~~~b~bb~~~
~~~b~~bb~b~~~~b~~~~b~~~~~~~~~~bbb~~~~b~~~~~~~~~~~~~~~b~~~~b~~b~~~~b~~~bb~~~bb~b~~bb~b~~~~b~~~b~~b~~~~
~~bbb~~~~~~~~~b~~bb~~b~~~bb~b~~~b~b~~b~bb~~b~b~~b~~~b~~~~~~bb~~~~~b~bb~~b~~~b~~~~b~b~~~~~~~~~b~b~~bbb
~~~bSb~~~bb~~~~b~~~~~~~b~~~~bbb~~~~~~bbb~b~~~~~b~b~~~bb~~b~b~~~~b~~~~~b~b~b~b~~b~~bb~~~b~~~~~~~~~~~b~
~b~bb~~~~~~~~b~~~~~b~~b~b~~~~~~~~b~~~b~~~~~bb~bbb~b~b~~~~~b~~bb~~~b~~b~~~b~~~~b~~~~~~~b~~~~~b~~~~~~~b
~b~~~~~b~~~~~b~b~~~~~~~bb~~~~~~~bb~b~~bb~~~~~~~~b~~~~b~~~b~~bbbb~~b~~~~b~~~~~~~~~b~b~~~~~b~~~~~~~~bbb
~~~~~~~b~~b~~~~~b~~~~b~~~~~~~~~~b~~~~bb~bb~~b~b~~~~~~b~~b~bb~~b~~~b~~~~~bb~~bbb~b~~~~~~~~~~bbb~b~~~~~
~bbb~~~~~~b~~~~~~~~b~~b~b~~~~~~~~~~~~b~~~~~~~b~~bb~~bbbbb~~~~~b~~~b~~~~~~~~~~~~b~~b~b~~~~~bbbb~~~~~b~
b~~~~~~~b~~b~~b~~~~~~~~~~~~~~bb~~~~~b~~~bb~~b~b~~~~bb~~~~~~~~b~b~b~b~~~b~~~~b~~~~~~~~bbb~bb~b~b~~b~~~
~~~~b~b~b~~bb~b~b~~b~~~~~b~b~~~bbb~b~~~~~b~~~~~bb~~~~b~~~~~~~~~~~~b~bb~~~~~b~~~~~b~~~~~b~~b~~~~~bb~~~
~~~~~~~~b~~~b~b~~~~~~b~~bb~b~~~~~b~~~~b~~~~~~b~~~~bb~~~~b~b~~~bbb~~~~b~b~~~~~~b~~~~~b~~~b~~~~bb~~~~~~
b~~b~b~b~~~~b~~b~~bb~~~b~bb~~~~b~b~~~~~~~b~b~bb~bb~~~~bb~~~~~bb~b~~b~~~~~~bb~~~b~~~~~bbb~b~~~~~~bb~~~
~b~~~~~~~b~~b~~~~~~b~~~~~b~b~b~~~~~b~bbbb~~b~b~~bbb~~~~b~b~~~bb~~~b~~b~b~~~b~b~~b~~~~b~b~~~~bb~b~bb~~
~~~~~b~~bb~~~~b~~~b~~~~b~~b~~~~~~b~~b~~~b~~~bbbbbbbb~~~~~bbb~~~bbb~~b~~~~~~~~~b~~~~~~~~~~~~b~~b~~~~~~
~~~bb~~~~~bb~~~~bb~~b~~b~~b~~~~~~~bbbbb~~b~~~~b~~~bbb~bbb~~b~b~~~~b~b~b~~~~~~~~~b~b~~~~~~~b~~~~~b~b~b
b~bb~b~~~b~~~~~~b~~~~~~~~~~~~b~~~~~b~~~~bb~~~b~~~b~~~~~~~bb~~~~~b~~~~b~~~~b~~~b~~bb~~~~~b~~~~~~bb~~~~
~~~bb~~~~b~b~~~~~~~~bbb~~b~b~b~~bb~bbb~b~~~~~~b~b~b~~~bb~b~~~b~b~~~~~b~~bbb~~b~~~~~~~~~~~bbb~~~~b~~~~
b~~~~b~b~~~~~~~~~~b~b~b~~~~~~~~bbb~~~b~bb~~~~~b~bb~~~~bb~~~~b~b~~~~b~b~b~~bbb~b~~~b~~b~b~~b~~b~bb~~b~
~~~~b~~~b~~~~~b~~~~~b~~~~~~b~bb~~~~b~~~~~~b~~~~~~~~~b~b~~~b~~~~~~~~~bb~~~~~~b~~~~~b~~~b~~~~b~~b~bb~b~
~~~~~~~b~~b~~~~b~b~~~bbbbb~~~~~~~b~~bb~~~~~bbb~~b~~~bb~~~~~~~bb~~~bb~~~~~bb~~~b~~~~~~b~~~~bb~b~~~bbb~
~b~~~~~b~b~~~~~~bb~~~~~~~~~~bb~~~~bb~~~~~~~~~~~~~~b~~~~~b~~bb~~~bbb~b~b~~~~bb~~b~~~b~~~b~~b~~~~~~~~bb
b~~bb~~bb~~b~b~~~b~b~bb~~~~~~~~~~~b~b~~~~~~~~b~~~~~~~~b~~b~~~~b~~~~~~~~~~~~~~~~b~~~b~~~~b~~~b~~~~~~b~
~~~~~~~~~~b~b~b~~b~~~~~~~~b~~~~b~~~~~~~~~~~~b~~~b~~b~~~~~~~~~~~b~~~~~b~~b~~b~bb~bbbbb~bb~~b~b~~~~~bb~
bb~~~b~~bb~~~bb~b~~bb~~b~b~b~~~~b~~~bb~b~bbb~b~~b~b~~b~~~~~~~~~b~~~~~~~~~~~b~~~~~~~~~~bb~~~~bb~b~bbb~
b~~b~~b~~b~~bb~~~b~~~b~~b~~~~~~~~~~~~~b~~b~~b~~~~b~~~b~~~~~~~b~~~~bb~b~~~bb~~~~~~~b~~b~~~~~~~~b~~~b~~
b~b~bb~bb~~~b~~b~~~~bb~~~~~~~b~~~~b~~b~~~~b~b~b~~b~b~~~~bb~b~~~~~b~~b~~~~~~~~~~~~~b~~~~~b~b~~bbbbbb~b
~~b~b~~~~~~~b~b~~bbb~bbbb~~~b~~~~~b~~~~~~b~~~~b~~bb~~~b~b~~~~~b~~b~~~~~~~~~b~~~~~~~~~~~~bbb~~~b~b~~~b
~~~~~~b~~b~bb~~~~~~~~~~~~~bbb~b~~b~~~~~bb~b~~~~~~~~b~~bb~bbb~~b~~~~~bbbb~~b~~~~~~~~~~b~~b~bbb~~~b~b~~
~b~~b~~~~~b~~b~b~~b~~~~b~~~~~~~~~~bbbb~~~~~b~~~~bbb~~~~~~~~~~~~~~~~b~~~b~~~~b~~b~b~~~~~b~~~~b~b~~b~b~
~~~b~~b~~b~b~~b~~~~bb~~~~b~bb~~~~bb~~~b~~~bbbb~~~~b~~bb~b~~~~~~~~~b~~~b~~~~~b~bb~~~~b~b~~~~~~~~~~b~~~
~~b~~~~~~bbb~~~bb~~bb~~~~bbb~bb~~~~b~~b~~~~~~~~~~b~~bb~~~~~~~~b~b~~~~b~b~~~~b~bb~~~~b~~~~~~~~~~~b~b~~
~~~~~~~b~~b~~~~b~~b~~b~~bbbb~~~~bbbb~~b~~~~bbb~~b~~~~~~~~~~~~b~~bbbb~~~~~~~bb~~~~~~~b~~b~~b~~~~~~~~~~
~~b~~bb~~~~bb~b~b~b~~~~~~b~b~b~~b~bbbbbbb~~b~b~~~b~~~~~~~~~b~~~~b~b~~~b~~~b~bb~b~~bb~~~~bb~~b~~~b~~bb
b~~~~~~~~~b~~~~~~b~~bb~~~b~b~~~~bb~~~~b~b~b~~~~~~~~~~b~~~b~~~bb~~b~~b~b~~~~b~~~~~~b~~~~~~~b~~bb~bb~~b
~~~~~~~~b~bb~~bbbb~~~~bb~~~b~b~~~~~~~~bbb~~~~~b~~bb~b~~~b~~~b~bb~b~~b~~~~~~~b~~~bbb~bb~~b~~bbb~~~~~bb
~b~~~~~~~~~~~~~~~~~~~~b~bb~bb~b~~~b~b~bbb~~b~b~b~bbbb~b~b~~bb~b~~~~~~~~~~~~~~b~b~bb~~~~~~~b~~~~~~~~b~
~bb~~~~~b~b~~~~b~~~b~~b~~~~~~~~~~~~~~~~b~~~b~bb~~~~~bb~~~~~~b~~~~~bbb~~~~~~b~~~~~~~~~~~~b~~~~~b~b~b~~
~~~b~b~b~~~b~b~~~b~~~~~b~~~~~~bb~~~bb~~~~~b~~~~~~~b~b~bbbbbb~~b~b~~b~~~b~~~~~~~~~~~b~~b~~~b~~bbb~~b~~
b~~bb~b~b~b~b~~~~~~~~b~~b~~~~~~~~~~~b~~b~~b~b~b~b~~b~~~b~b~b~b~~~b~~~~b~~b~~~~~b~~~~b~b~~~b~~bb~b~b~~
b~~~~~~~~b~~~~bbb~b~b~~bbbb~~~~~~~b~~~~~~~b~b~b~~~~~~~~~~~~b~~bb~b~bb~~b~b~~b~~~~~~~~b~~~~~b~~bb~~~~b
~~~~~b~~b~~~~b~~b~b~~~~b~~~~~b~~b~~~b~~~~~~b~~~~~~~~~~~~~~~~~~~~~~~~~~~~b~~~~~~b~~bb~~bbbbb~~~b~~~b~b
~~b~b~~bb~~bbb~~~~~b~~~~~b~~~~~~~~~~~~bbb~~b~~~~b~b~~b~~~~~~~~~~~~~~b~~b~~~b~~bb~bb~~b~~b~~bbb~~b~bb~
~~~~~~~~~~b~~b~~~~~~~~b~~~bb~~~~~~bbb~b~b~b~~b~~b~~~~~~~~~~~~~~~~~~~~~~~~~~~~~~~b~~~~~~~~~~~~~b~b~b~b
~bb~~~bb~b~~bb~~~~b~~~b~~bb~b~bbb~~b~b~~~b~~~~b~~~b~~b~~bb~b~~b~~~b~~bb~~bb~bb~~~~~b~~~~~b~~bb~~~~~~~
~~~b~~~~b~~bb~b~~b~~b~~~~~~~~~b~bb~~~b~bbb~~~~~bb~~b~~bb~~~~~~~~b~b~b~b~~bbb~bbb~bbb~b~~~~b~b~~~~~bb~
~b~b~~b~bbb~b~bb~~b~~~~~~~~~~~~b~b~b~~~b~bb~bb~~~bb~~b~~~~~b~~~b~b~~~b~~~~~~~b~~~~bb~~b~~~~b~~~~~~~~~
bb~~~~bb~~b~~~~~~bbb~bbb~~~~~~b~~~~~~~~~b~b~~~~b~bb~~~~bbb~bb~~~~b~~bbb~~~~~~~~bbb~b~~~~~~~~b~~~~~~~~
~~bb~~~~b~b~~~b~b~~~~~~b~~b~b~b~~~bbbbbb~~~~~b~b~b~~~~~b~~~~b~~~~~~b~~~~bbbb~~~bbbb~~~~~~~b~~~~~~b~b~
~bbb~~~~~~~~b~~~~~~~~~~bbb~~bbb~~b~~b~~~~~b~~bb~~b~~~~~~~~~b~~b~~~~~~~~b~~~b~~~b~~~~~~bb~~~~~bb~bb~b~
~~b~~b~bb~b~~~b~bbbbb~~~~~bb~~b~~~~~~~~~~b~b~~~~~bb~~~~b~~~~bb~~~~~b~~~~~~b~~b~~b~~~b~~~~bb~~~bbb~b~~
~b~~~~~~~~~~~~~~~~bbb~~bb~~~~b~~~b~~~~~~~~~~~b~b~~bb~bb~~~~~~~~~b~~b~~~bbb~~b~~~~~~b~b~bb~b~b~b~~~bbb
~~~~~bbb~~~~b~~b~~~b~~~~~~~~~~~~~~~~~~bbb~~~~b~~~~~~~b~~bb~~~~b~bb~~~~~~~b~b~bb~~~~b~~b~~b~~~~bb~b~~~
~~~~~~~~~bbbb~~b~~b~~~b~~~~~~~~~~~~~~~~b~~~bb~~b~~~b~~bb~~~~b~~~~b~~~~~~bbb~~~b~~~~~~~~~~~~~~~~~~~~b~
bbbb~b~~b~~~b~~~bb~~~~b~~~b~~~~~~~~~bbb~b~b~b~~~~~bb~~~~~b~~~~~~~b~b~~~~b~b~~b~b~b~~b~~~~~~~~~bb~~~~~
~~~~bb~b~~bb~~~~~bb~~~~~~~~~bb~~~~~~bb~~~~~~~~~bbb~~~bbb~b~~b~~~~~~~~~~~b~~~~~~~~~~~bb~bbbb~~~b~bbbb~
~~~~~bb~~~~~~bb~bb~~b~bbb~~~b~b~bbbb~b~bb~~~b~~~~~~~~bbb~bbb~~~~b~bb~~~~~~~~bb~b~~~~~~~bbbb~~~~~b~~~b
bb~~~~bb~~~~~bb~~~b~~~bbb~b~b~~~~~~~~~bb~~~~~b~~~~~b~b~~~~~~~~~~~~b~b~~b~b~b~bb~bb~~~~~~~~~~~bbb~b~~~
~b~~b~~bb~b~~bb~~bb~bb~~b~~b~~~~b~b~~~~~b~~~~~~b~b~~~~bbb~~b~b~~b~~~~bb~~~~b~~bb~~b~~~~~~bb~b~~b~b~~~
~~~~~~~~b~~~bb~~~b~~b~b~b~~bb~~~b~bb~~b~~~~~~~~b~~~b~~~~~~~~b~~~~~~b~b~~~~~~bb~bb~~~~~~~~bb~b~b~b~~~~
~b~bb~~~bb~b~~bb~b~~~b~~~~~~~~b~~~b~~~b~b~~~~~~~b~~~~~b~~~~~~~~bbb~~~bb~b~~~~~~~~~bb~b~~~bb~~~~~~~~~b
~b~~~~~~~~~~bb~~b~~bbb~~~~~~~~~~b~~~~~~~~~~~b~~~~~b~~~~~~~~~~~~~~b~~b~b~~~~~~~~~~~~~~~bb~~b~~~~bbb~~~
~~b~~~bb~~b~~~~b~b~~~~b~~~~~~b~~b~~~~~bb~~~~~~~b~b~~b~~b~b~bb~~~~~b~~~b~~~~~~~~b~~b~~~bbbb~b~~bb~~~~~
