~b~~~~~b~~~b~~~b~bb~~~~b~~~b~~~bbbb~~b~~~~~~b~~b~~~bbb~~~~~~~b~bb~~b~~~~~~b~b~b~~~~~bbb~~~b~~b~~~~~b~
~~b~b~~bb~~bb~b~~b~~b~~~~~b~~~~b~~b~~b~~~~~~~~bb~b~~~~bbb~~b~b~~~~~~b~b~~b~~b~~~~b~~b~~~~bb~b~~~~~bb~
~~~bb~~~~~~b~~bb~~b~~~~~~~~b~~~~~~~bb~b~~~b~~~~~~b~b~bbb~~~b~~~b~~~~bb~~b~~b~~bbbb~~~~~~~~bb~~~~~~~~~
~b~~~b~~~~bb~b~~b~b~~b~~~bbb~~~b~b~~~~~~~~~b~bb~b~~~~~~~bbb~bb~~~~~~~b~b~~~~~~~~b~b~bb~b~b~~b~~~b~~~~
bbb~b~~b~b~b~~b~~~b~~~b~~~bbb~~b~b~b~~~~~bb~bb~~~~~~bb~~~~~b~b~~~~b~~b~~~~b~~~~bb~~~~~~bb~~~bb~~~~bb~
b~~~~~~b~~~~bbbbb~b~b~~b~b~~~b~~~~~~~~~b~b~~~~~~bb~~~~~~~~b~b~~bb~b~~bb~~~~~~~~~b~~~~b~~~b~~b~~~b~~~b
~~~~b~~~~~~~~~~~~~~b~~bb~~b~bb~~b~b~~b~~b~~b~~~bb~bb~b~~b~b~b~~~~~~~~~~b~~~~b~~~~~b~~b~~~~~~~~b~~b~~~
~b~~bb~~~~~~~b~~~~b~bb~~~b~~bb~b~~~b~b~~~~b~b~~~b~b~b~~bb~bb~bb~~~~b~~~bbb~~~~~bb~~~~~bb~~~~~~~~~~bb~
~~~~b~~~~b~~~~b~~~~b~b~b~~~~~~~~~~bb~~bb~bbb~~~~~~b~~~~b~~~b~bb~bb~~~b~~bbbb~~~~~~~~b~~~~~~b~~~~bb~b~
~~~~b~~~~~~~~~~~~b~~b~~~~bb~b~b~~~~~~bb~~~b~~~~~b~~~~b~~~~b~bbbb~b~~bb~~~~~~b~~~bb~~~~b~~~~b~~~~~~b~~
~~~bb~bb~~~b~~~~~~b~~b~~~~~b~~bb~b~~~~b~~~~~~bb~b~b~~~~~~~~~~bb~b~b~~~b~~b~~~~b~bb~b~~bbbb~~~~~~~~~~~
~b~~~~b~b~~~~~~~b~~~b~~b~b~~b~~~~~~b~~~~bb~~~~bb~bb~~b~bbb~~~bbb~b~~~b~bb~~b~~~~b~~~~~bb~~~~~~~~~~~b~
b~~~~~~~b~~~b~bb~~~~~~~~b~b~~~~~~~b~~bb~b~~b~bb~bb~~~b~bb~b~~~~bb~~~b~~~b~~~~b~b~~~~~~b~~~b~~~~~bb~~~
~~~~~b~~~~~bb~~~b~~~~b~~~~bb~~~~~~b~~~~~b~b~~~bb~bb~~~~~~b~b~~~~~~b~b~~~b~b~~~~~b~~~~~b~~b~~b~~~~~~~~
~~~~b~~~b~b~~~~~~bb~~~~b~~b~~~~b~~~~b~~b~~~~b~~~bbb~~~~~~~b~b~~~bb~~~~~b~b~~bbb~~bb~~~b~~~~b~~~~~b~~~
~~~~b~~~~~~~~~~~b~b~~b~~~b~b~~~~~bb~b~~bb~bb~~b~~~bbb~~~~~~b~~~~~~~~b~~~~~bb~~~~~~~~~~~~~~b~~~~~~~bbb
~~b~~~b~~~~~~~~~bb~~~~b~~bb~b~~~b~~~~b~~~~b~bb~~~bb~b~~~b~~b~~~~~b~~~~~~b~b~bbb~~b~~~~~~b~~~~~bb~~~b~
~b~~b~~~b~~~~~~b~~bb~~~~b~~~~~~~~~b~b~~~~~~b~~~~b~~b~~~~b~~b~~~b~~~~~bb~~~~~~~bb~~bb~~~~~~bb~~~~~~~~~
bbbb~~~bb~b~~~~~~~~~~~~~b~b~~~~~~b~b~~~~~b~bb~~b~~~b~~~~~~~b~~bb~~~~~~~~~b~~~~~~~b~bb~bb~~b~b~bb~~~b~
~b~bbb~~~b~~~~~b~~~~bbb~~~~b~~~~~~~~~b~bb~b~bbbbb~b~~~~~~~b~~~~b~bb~~~b~~~bb~~~b~~b~~b~~b~bbb~~~~~~~~
~~~~~~~bb~b~~b~~~b~~~~~~~~~b~~~~~b~b~b~b~~~b~~~~b~b~bbb~~~b~~~~~bbb~~~~~~~~~~~b~~b~~b~~b~~~~~~~~b~~b~
~~~~~b~~~bb~~~~~~~b~~~~~~~~b~~~b~~~~~~~bb~~~~~~b~b~~~bbb~~b~b~~~~~b~b~~~~~~~b~~~~bbb~~~~b~~bb~~~b~~bb
~~~~~bb~~~~~~~~~~~~~~~b~~bb~~b~~~~~~~~~~~~bbb~~b~~b~~b~~~b~~b~~~~bb~b~~~b~~~~b~b~~bb~~~~b~~b~~b~b~~bb
~b~b~b~~~~~~b~~bb~b~~bb~~~~~~~b~b~b~~~~~b~bb~b~b~~bb~~b~bbb~b~~~~b~~b~b~bb~~~b~b~~b~b~~bbb~~~~~~~bb~~
bb~~~~b~~~~~b~~~b~~~~~~b~~bb~~bb~b~~~~~~~~~~b~~~~~~b~~~b~~b~b~~b~~~b~b~~~~b~b~~~~~~~~b~b~b~b~~~~~~bbb
bbb~~~~~b~b~~~~~~~b~bb~~~b~~b~~~~b~~~b~b~~~~~b~~~~~~b~~~b~~~~bbbbb~~~~b~~b~~~~b~~bb~b~~b~~~~~~~~~b~~b
b~b~b~~~~~~bb~b~~~~~b~~~~bb~~~~~~~~~b~~~b~~~~b~~b~~~~~~bb~b~b~~~~b~b~~~~~~~~~~bb~b~~~b~~b~b~~~~bbbb~~
~~~~~~~~~bb~~~~~b~~b~~~~~bb~bbbbb~~bb~~bb~b~~~~bb~~b~~~~~~~~bbb~~bb~~~~~bbb~~~~~~~~~b~~~~~bb~~~~b~b~~
~bb~~~~~~~~bb~b~b~b~b~~~~~~~bb~~~~~~~~b~~~~b~~b~b~b~~~b~~~~~~b~b~b~bb~~~b~~~~b~~~~b~b~~bb~~~b~~~b~~~~
~~~~b~b~~b~~b~~~~bb~~~~~~~~~b~~bb~~b~~~bb~~b~~~~~~~~~~~~b~~~b~~~b~~~~~~b~b~b~~~~b~bb~~b~bb~~bb~~bb~~~
~~b~~~~~~~b~~b~b~~b~~~b~~bb~~~b~b~b~b~b~~~~~b~~bb~~bbbbb~~b~~bb~~~~~b~~~b~b~~~~~~~~~~~~~b~b~b~bbbb~b~
~~~~b~~~bb~~~~bb~~b~~bb~bb~b~~~~~~b~~~~~~~~~~~~~~bb~~~b~bb~~bbb~b~~~~~~~~b~~b~~~~b~~bb~b~~~~~~b~~~~~~
~~b~~b~b~~~~~~~~~~bb~b~~b~~bb~~~~~~~~~~~~~~~bb~~~~~~~~~bb~b~~~bb~~b~~bbb~~b~~~~b~~~~b~~~~bb~~~bb~~bb~
~bb~~~b~~~~~~~~b~~~~~~~~bb~b~~~~b~~b~~b~~~~~~~bb~~bb~~bb~~~~~b~~~b~b~~~~b~~b~~~bb~~~b~~bb~~b~~bb~~~~~
~~b~~~b~b~bb~~~~~~~~~b~~bbb~~~~b~~~b~b~bb~~~b~~~~b~bb~~~~~bbbb~~~~b~bbb~~b~~~~b~b~~~b~bb~~bb~~b~~~~~~
b~~~~~b~b~~~~~~~b~b~~~~~~~b~~~~bbbb~~~~b~b~~b~~~bbbbb~~~b~~~~~bb~~b~bbb~~b~~~~~~~~bb~~~bb~~bb~~~~b~~~
b~~b~~~~bb~~b~~~~~~~~bb~b~~~b~~~~bb~~~~~~~~bbb~bbb~~bb~bb~b~~bb~~~b~b~b~~~b~~~b~~~~bb~~~~b~~~~~~~~~~b
~bb~~b~~~~~~bbb~bbb~~~~bb~b~~~~~~~~bb~b~~b~~~~~~b~b~~~bb~~~~~~b~~b~b~~~~~~~~~~~~b~~~~~~~~~~bbb~~bb~~b
~b~b~b~~b~~~~b~~~~~~b~~~~~~~b~bb~b~b~~~~~~b~~~b~~~bb~~~~~~~b~~b~b~~~b~~b~~b~b~~b~~~b~~b~~bb~~~~b~~~b~
b~~~b~~bb~bb~~~~b~~~b~~~bb~~~b~bb~~~b~~~~~~~bb~b~~b~b~~~~b~~~~~~bbb~b~~b~~~~~~~~~~b~~~bb~~~~~~~bb~~b~
~~bb~~~~~~bb~~~b~~~~~~~~~~b~~~~bb~b~~~~~bb~~~~b~b~~b~~b~~b~b~~~~~bb~~bbbb~~~~~~b~~~~~b~b~~b~bbb~bb~~b
~~~~b~~~~~~~~~~~~b~~b~~~b~~~~b~b~~~~b~~b~b~~~~~~b~~b~b~~~~b~bb~b~~~b~bb~bbb~bb~~~~~bb~b~~~~bb~b~~~b~b
b~b~~b~~~bbb~b~~~~b~b~~bb~~b~~~bbb~~~~~b~~~~bb~~b~~~~~bb~~~~~~~b~~~bbbb~bb~~~~~~b~~~b~~b~~b~~~~~~~~b~
~~~b~~~~b~b~~~bb~~~~~~~~bb~~bb~~bb~b~~~bb~~b~~~bbb~bb~~b~~~b~b~b~bb~~~b~~b~~~~b~bb~b~b~bb~~~~~~~~~b~~
~~~bbb~~~~~~~~~~b~b~bb~~b~bbb~~bb~~~b~~bb~b~b~~~~~~~~~b~~~bbbb~~~b~b~~b~~~~~~~~~b~~b~~~~b~~~~~~~~~~~~
bb~~~~~~~~~b~b~~~~~~~b~~~~~~~~~~b~~~~~b~~~~~~~~~~b~~~b~~~b~b~b~~~bbb~~~b~~bbb~~bb~b~~bb~~~~~~~~~~~bb~
bb~~~~b~~b~~~b~b~b~b~~b~~~~~b~~~~b~~~~~b~~~b~~~~~b~~bb~b~~~bb~~~~~~b~~~~~b~b~~~~~~b~~~~~~~~~~~~~b~b~~
~~b~~b~~b~~b~bb~~~b~~~b~~~~~~~~b~~~~~~~~~~b~~~~~~~~~~~b~bbb~~~b~~b~~b~~b~bbb~~~~~~~~~~~b~bb~~bb~~~~bb
~~~~~b~~~b~~~~~~~~b~~b~~~~~b~~~~~~bb~~~~bb~~~~~~~b~~~~~b~~~~~~b~~~b~~~b~b~b~~~b~~b~~~bb~~~b~b~~~~b~~~
~~~~~~~b~b~~~~~~b~~~~bb~~~~~b~~~~~b~b~~~~~~b~bbbb~b~~b~~~~~~bb~~~b~b~~b~~~b~~~~b~~~~~~b~~~~~~~bb~~~~~
~bb~bbbb~~b~~~~b~~bb~bb~~b~b~bbb~~~bbb~~~~b~b~~~~b~bbb~bb~~~~~b~~~~~~~~~~~~~~~~~b~~~b~~~~~bb~b~~b~~b~
b~~~~b~b~~~b~~~bb~b~~~b~~~bbb~b~~~~~~~~~~~~b~bb~~~~~b~b~~~~~~~~~~~~~b~b~~~~bb~~~bb~~~~~b~bb~~~~~~~b~b
~b~~~~~~b~~~~~bb~~~~bbb~~b~~~b~b~~b~b~~~~b~bb~b~~~~b~bbb~~~b~~~b~b~~~bbb~~~bbbb~b~~b~~~~~bb~~~bbbb~~~
~~~~~b~~b~b~~b~~b~~~~b~~~~b~~~~~b~b~b~b~bb~~~b~~~b~~b~b~~~~~~~~bb~bb~b~~b~~~~~~~~~~b~~~~~~b~~~~~~b~~~
~~~b~b~~~bb~~~b~bb~~~~~~~bbbbb~b~~~bb~~~bb~~~b~b~~bb~b~b~~bbb~~~~~~~~~~~~~b~~b~~b~~~~~~b~~~~~~~b~~~~~
~~~b~b~~~b~~~bb~~b~~~b~b~~~~~~~b~b~b~~~~bb~~~b~~~bbb~~bb~~b~bbbb~~~~~~bb~~~b~bb~~b~~b~b~~b~bb~b~~bb~~
~~~~~~~b~~~bb~b~bbb~~~b~b~b~~~~~~~b~~~~bb~~~~b~b~~~~~b~~~~~bb~bb~bb~~~~~b~b~b~bb~~~b~~~~~b~~b~b~~b~b~
b~~b~bb~bb~b~~~~~b~b~~~~b~~~~b~~bb~~~~b~~~~~bbb~~~bb~b~b~~~b~b~~b~~~~~b~~~b~~b~~~~b~~b~b~~b~~b~~~b~b~
b~b~~~~~~~b~~b~bb~~~~b~~~~bbb~~~~~~~~~b~~~b~b~b~bb~~~b~~~bb~~~b~~~~~~b~b~b~~~~~~~~~~~~~~~bb~~~b~~b~~~
b~~~~~~b~~~b~~bb~~~~b~b~b~~~bb~b~~~~~b~~bb~b~~~bb~b~~bb~~~bb~b~~~~~bb~~bb~~~~b~~~b~b~~bb~~~b~~b~b~~~~
~~~~~~~bb~bb~~~~~~b~~b~~bbb~~~~bbb~b~~b~~~b~~bb~~~~b~~~~~~bbb~~b~~~~~b~~bS~~~~~~~~b~~~~~~b~~~~~b~b~~b
~~~~~~bb~b~~~~~b~b~~b~~~bbb~~~~~~b~b~~~~~~b~bbbb~~~~~b~bb~b~bb~~~b~b~~~~~b~~~~~bb~~b~~~b~~b~~~~~~~bb~
~bbbb~~~b~~b~~b~~bb~~~~~~~~~~bb~b~~~~bb~b~~b~b~~~~~~~b~~~~~~b~bb~~~~~~~~bbb~~bb~~~~~bb~~~~~bbb~b~~~~b
~~~bbb~bbbb~~bb~~bb~bb~~~~~~~b~~~b~b~bbbb~~~~~b~~b~~~~~~b~~~bb~~~b~~~~~b~~~~~~b~bb~~b~~~b~b~~b~~b~b~~
~~b~b~b~~~~~~b~~~~~~~b~b~~~b~~b~~b~b~~~b~~~~bb~~~~~~~~b~~~~~~~~~~~~~b~b~~b~~~~~b~~b~~~~b~~b~~b~~~~b~~
~~~bbb~~~~b~~~~~~b~~~~~~~b~b~~~~b~~~~b~~b~~b~~~~~~b~~~~bbb~~~~~~~~~bb~bbb~b~~~~~~b~b~~~b~bb~b~~~bb~b~
~~~b~~b~~b~b~~b~~b~~~bb~bb~bb~~~~~bb~b~~~bb~b~b~~~~~bb~b~~~~~~b~~b~~bb~~~~~~~~bb~~~~~~~~b~~bbb~~b~~~~
~~bb~b~~~~~b~~~~b~bb~~~~~~b~~~~~bb~~~~bb~~~~~~~~~~~~~~~~b~~~~b~~~~~b~~~~~~~~b~~b~~b~~~~~~~~~~~b~~b~~~
~~~~~~~b~~~~~~b~~bb~bbbbb~~bb~~~~~bb~~~~b~~bbb~~~b~b~b~bb~b~b~~~~~~~~~~b~~b~~b~bb~~~b~b~~~~bb~~~b~~~~
~b~b~~b~~~~~b~~b~~b~~bb~~~b~bb~bbb~~b~~~~~~~~b~bb~~~b~b~~~~~~~b~~~~~bb~bb~~bbb~~~bb~~~~~~~~b~~b~~~b~~
~~~~~~~bb~~b~~b~b~b~~~b~~~~bb~~~~b~~b~bb~~bb~~~~~bb~~~b~bb~~~~~~b~~~~~b~b~~b~b~b~bb~~~~~b~~~~~~~~~~~~
~~~~~~~~b~~~b~~b~~~bb~~~~~b~~bb~b~~~b~~~~~~b~b~~~~b~~~~b~b~bb~~b~b~~b~~b~b~b~bbbb~~b~~bb~~b~~bbb~~bb~
bbbbb~b~~~b~~b~b~~~~~~bbb~~~~~~~~~~~~b~~~b~~~~~b~~b~~~~~~bb~~~b~~b~~~~~~bb~~bb~~b~~~~~bbb~~b~~~~~b~bb
bbb~~~~~~~b~~~~~~~~~~~~~~~bb~b~~~~~b~~~~b~~~~b~~~~~~~~~~b~~~~~~bbb~b~~b~~b~b~~~~~bb~~b~~~~~~bb~~~~~~~
~~bbb~~~b~~~~~~~~~bb~~~~~~~~~b~~~b~~~bb~~b~~~~~~~~~~~~~~~b~~~~~~~~~~b~b~bb~~b~~~bb~b~~~~bb~~bbb~bb~~b
b~~~b~b~~~~bb~~b~~b~~b~~~~~b~b~~b~b~~~~bb~b~~~bb~b~~b~b~~~~~~~~~~~bb~~b~~~~b~~~~~~~bb~~~~~~b~b~b~b~bb
~~~~b~~~~~~~~b~b~~~b~~b~~~b~~b~~~b~~~~~~~~~~~~~b~b~~~~~b~~b~~~bb~~~bb~~~b~bb~~~~~b~~~~~~~b~~~~b~~~~~b
~~~~~~~~bb~~~b~b~~bbb~bb~~b~~~~~~~bb~~~bb~~b~~b~~~~~~~~b~~~~~~~~~~~bb~~~~b~b~bb~~b~~~b~~~~~~b~b~~~~~b
~~~b~b~b~bb~~~~~~~b~bb~~b~b~~~b~b~b~~b~~~b~bbb~~~b~~~~~b~~~bb~~~~~~~b~~~~bb~~~b~~b~~b~~~~~~~b~~~~~~b~
~bb~b~~~bb~~b~~b~~~b~~b~~bb~bbb~~~~~~~~~b~~b~~~~~~~~~~b~~~~~~~b~~~~~~~b~~~~~~~~~~~~~b~~bbb~~~~~~b~~~~
~b~b~b~~~bbb~~~~b~~b~b~~~~~~~~~b~b~~~~~~~bbb~b~b~~~~~b~~~~b~~~~~~~~b~~~~~~~b~~~b~b~~~b~b~b~~~b~b~~b~~
~~~~~~bb~~~b~bbb~b~~~bbb~~~b~~~b~~~b~bb~~b~~b~b~b~b~~~b~~~~bb~~~~~b~~~~~~~~~~~b~~b~~~~bb~~~bb~b~~~b~~
~~bb~~bb~~b~~b~~b~~b~~b~~bbb~b~~b~~~~~b~~~~~~~~~~b~~~b~~~b~b~~b~~~~~~~bb~~~b~b~~~b~~~~b~~~b~~~~~~~~b~
~~~~bb~~~~~bb~~~~~~b~bbb~b~b~~~b~~~~~bbb~~b~b~b~b~b~~b~~~~~~~~b~b~~~~~bb~~~b~~b~~b~~~~b~~b~~b~~~~~bb~
bb~b~b~~b~b~~~~~~~~~~~~~b~~~~~~b~~~~~~~~~~~~~~b~~~~~~~b~~~b~~~b~~b~b~~~~~b~bb~~~b~~bb~~~~~b~~bb~b~~~~
~~~~~~b~~~~~bbb~~~~~~~~~~~~~~~~~~~~b~~~~~~b~G~~~~~bb~~~~~b~b~b~~~~b~~~~~~~~~~b~b~~bb~bb~~bb~~b~~~~~~b
~~b~~~~~~~~~bb~~~bbb~b~~~bb~~b~~bb~bb~b~~~bb~~~~~b~~b~bb~~~~b~~bb~b~~~~~~~~b~b~b~~~~~~~~~~~~b~~~~~~~~
b~~b~~~~~~~~bbb~bb~~b~b~b~~~~~~~~~bb~~~~~bb~~b~~~b~~~b~b~~b~~~~~~~~~~b~~~~~~~~bb~~~~~~~bb~~~~~~~~b~~~
bb~b~~~~bbb~~b~b~~~~~~b~~~~~~b~b~~~~~~b~~~~b~b~~~~~~~~~~b~~~~~~~b~b~bbb~~~b~~~b~b~b~bbb~~~~~~~bb~~~bb
~~~~~~~~~~~~~b~~b~~~~~bb~b~b~bb~~~~~~~~~~b~~b~~bbbb~~~~b~~b~~~b~~~~b~~~~b~b~bb~~~~bb~b~b~~~b~~~bb~bbb
~b~~~b~~~~~~~~bbb~~~b~~~~~~~~~~~~b~~~bb~~~~b~~b~~~~b~~~~b~b~~~~b~~~~~~~~~bb~b~~b~~b~~~~~~~~bbb~b~~~~~
~b~bb~~b~~~~b~bb~bbb~~~~~~~b~~bb~b~~~~~~b~~~~~b~b~~~~b~bb~~~~~~~~~~~b~b~~~b~~~b~~~~b~~~b~~~b~~b~~b~b~
b~b~~~~~b~~~~b~bbb~bb~~~~~~~~~~b~~~bb~~bbb~~b~~~~~~b~~b~~~~~~~~~~~~~~~~~b~~b~~~~b~~~~b~~~bb~~~b~b~b~~
bb~~~b~bb~b~~b~b~b~~b~~~~~~~~~~~~bb~~~b~~bb~~b~b~b~~~~b~~~~~~~~~b~~~b~b~~~~~bb~~~bb~bb~~~~~~b~~~~~~~~
bb~b~bb~bb~~~~~b~~~~~~~~~~~b~~b~~~~~~~~~~~~~b~~bbbb~b~~~b~b~~~b~~b~b~b~~~~~~~~b~b~bb~~~bb~b~~b~~b~~~b
~bb~~~~~b~~bb~~~~~~~~~b~~~b~bb~~b~~b~b~~~~~~bb~bbbb~~~~~~bb~~b~~~~~~b~b~b~~~~~bb~~~~~~~~b~~bb~~~b~~~~
~~bb~~b~~~~b~~~~bb~~~b~~~~b~~~~~~~~~~b~~~~b~b~~~~~~~~~~~~~bbbb~~~bbb~b~~bb~~b~b~b~~~bb~b~~~b~b~~b~b~~
~~~~~bb~~~~~~~~~~b~~~~b~~~~b~~bb~~~~b~~~~b~~~~~~~~b~~~bb~~~~bb~~~~b~~~~~~~~~~~~~b~bb~~~bbb~bb~~b~~~b~
b~~~~~b~bbb~~~~~b~~b~~b~~~bbb~~~b~~~~b~~~~b~~~~bb~~~~b~b~~~~~~bbb~~b~~~~~~~~bbb~bb~~bb~~~~bb~b~~~~b~b
~b~~b~b~~~bb~b~~bb~b~~bb~~b~~~b~b~~~b~~~b~~~bb~~~~~b~~~~~~b~~~b~~b~~~~~b~b~~~~~~~bb~b~~~b~b~~~~~~bb~~
b~~bb~b~~~~b~~~bb~~~~b~b~~b~~~b~~~~b~~b~~~bb~~~b~~b~~bb~~~b~~~~~bb~~~~~~~~~bbb~~b~~b~~~~~~~b~bb~~~~~~
