~~b~~~~~b~~~~~~~~b~b~~~b~~~~b~bb~b~~~~~bbb~bb~~~~~~bb~~b~~b~b~~bb~~~~~~~~~~~~~~~~b~~~~~bb~~~~~~bbbb~~
~~b~b~~~~~~~~~~b~~b~~~b~b~b~~~b~~~~~~b~~~bbb~b~~~~~~~b~~bb~~~~~b~b~~~b~~~~bbb~~~b~~~~b~~~~~b~~~~~~~~b
~~~~~~~~b~~bb~~~~~~~b~~~~~~bb~~~~~~~b~~~~b~bb~~~b~~b~~b~~~~~~bb~~b~~~bbb~~b~~~~~~bb~~b~~bbb~~bb~~~~~~
~~~~~~~~bb~~~b~b~~~~~~~~~~~bbbb~~~~~~bb~bb~b~~~~~~~~~~~~~~~~~~~~~b~~~~bb~~~bb~~b~~~b~b~~~bb~~~~b~bb~~
~~~bb~~~~~~~b~~~~~~~~~~bb~~~bbbb~b~bbb~b~~~~~bbb~~bbb~~bb~~~bb~~~~~~~~~~~b~~~b~~~~b~~~bb~b~~~bbbb~~b~
~~~bb~~~bb~~~~~~~~~~~~b~~~~b~~~~~~~~~b~~~~bbb~~~b~~~~~b~~b~~~~b~~~~bbb~~b~~~~~~bb~~~b~bb~b~~~b~b~~bb~
~b~bb~~~~~b~~b~~~~~bb~bbb~b~~~~~~~~~~b~~b~b~bbbbb~~~~~~~~~b~~bb~~~b~b~~b~b~~bbb~~~~~b~~~~~~~bb~b~b~~~
bbb~~~~b~~~~~b~~bb~~~~~~~~~b~~~~~bb~~~~bbbb~~b~~~~~~~~~~~b~~~~~~~bb~~~~b~~~~~~~~~~~~~~~~~bb~~~~b~~b~~
~bb~~~~b~b~~~~bbbb~~b~bb~~b~~b~b~~~~~b~bbb~~b~~~~~~b~~~~~~~~bbb~b~bbb~~~~~~bb~b~bb~~b~~b~~~~~~b~~b~~b
~b~b~~~~~~bb~bb~~bb~b~~b~~bb~~~~b~~~~~~~b~~~~~b~bb~~~~~~b~~~b~~~b~b~bb~~b~~~b~~~b~~~b~b~~~~~~b~b~~b~~
~~~~~bbb~b~~b~bb~b~~~~~~~~b~~~b~bb~~~~~b~bb~~~~bb~~b~~~~b~b~~b~~~~~b~~b~bb~~b~~b~~~~b~~~~b~~~b~~b~b~b
~~~~bb~~~b~~b~~~~~bbb~~~~~bbb~~~~~~bb~~~b~~~b~~~~~~b~~~b~bbb~~~~~~~~~~~~~~bb~~~b~~b~~~~~~~~~~~b~~~~~~
~bb~~~bb~~b~~~b~~~b~b~~~~~~~~b~b~bbb~~~~~~~~~bb~~~~~b~~~~~b~b~~~~~bb~~~~~b~~b~~~~~b~~b~~b~~~b~~~~~b~~
b~bb~bb~~bb~~~~~b~~~~bbb~~~b~~~b~bbb~~b~~~~b~~~~~bbb~~~bb~~~bb~bbb~~~~b~~~~~~b~b~~~~~b~~~~~~~~~~bbb~~
bbb~b~~~~b~~~~~bb~~~~~~bb~~~~~~~~b~~~b~~bb~~~~~~b~~~~~~~~b~~~~b~~~b~~~bb~~~~~~bb~b~~~~~b~bb~~~~b~~b~~
b~b~~b~~~~b~~~~b~~~~~~~~~~b~bbb~~~~~bb~b~~bb~~~~~~~b~b~~~bb~~~~bb~b~~~b~~b~b~~b~~~b~~~~b~bb~bb~~~~~~~
~b~~~~b~~bb~~b~bbb~~b~b~~bbbb~b~~b~~~b~~~~~~~~~~b~~b~~~~bbbbb~b~b~~bb~~~~~~~~bbb~~~~~~~b~bbb~bbb~~~~~
~~b~~b~~~~~b~b~~~~~~~~~~bb~~~~~~~~bb~bb~b~bb~~~~~~~~b~~~~~~~~~~~~~b~~b~~~b~~b~bb~~b~~bbb~b~~~~~b~b~b~
~b~~~~~~~bb~~~~~~bb~~~~b~~b~~b~~~~b~b~~~~~~~~~b~~~~~bb~~~~~b~~~~b~bb~~~b~~~~~~~~~~bb~~~b~~b~~~~~b~~~~
~~bbb~~b~b~~~b~~~~b~b~~~~~bb~~~~~~~~~bb~~bbb~~~~~~~b~~~~b~b~b~~~b~~~b~~bb~~b~~b~~~b~~~~~~~~b~b~~~b~~~
~~~~b~~~~~b~~~b~~~~bbb~b~~~~~~~~~~~~~b~~b~b~~~~~~b~b~~b~~~b~~bb~bbb~~~~~~~~bb~~~~b~~~~~~b~~~~~~b~b~~b
b~~~~b~~~b~b~~~b~b~bb~bbb~~~~bb~~~~b~~~b~~~~~~~~~b~b~b~b~~~~~~b~~~~~~~b~~~~b~~~~~~~~b~~~~~b~b~bb~~~~~
b~~~~~~~b~~~b~b~~~~b~~~~~b~~b~~~~~b~bbb~bb~~~~~b~~~b~~~bb~~~~~~~b~bb~~~~b~b~b~bb~~~~~~~b~~~~b~~bb~bb~
~~b~~~b~~b~~~bb~~~~~~b~~~bbb~b~~~~~~~~~~~~~~~~~~b~~b~~~~~b~~b~~~~~b~~~~b~b~~~~~~~~bb~~b~~~~b~~bb~b~~b
~b~~~b~~~~~b~b~~bbb~~b~b~~~~~~b~~~~~bb~~~~~bb~~b~~~~~b~b~~~~b~~~b~b~b~~~~b~b~b~bb~b~~~~~~~~b~~~~~b~~~
~~~~bbbb~~~b~~~~~~bb~~~~b~~b~~b~~~~b~~~~bb~~~~bb~bb~~~~~~bb~~b~b~~~~~b~b~~~~~~~~b~~~~~~~~~~~~~b~~~~~~
bbb~~~~~b~~~~~~b~b~~~~~~~b~~~~~bb~~bb~~b~b~~b~~b~~~b~~b~~b~~b~~~~~b~b~b~~b~b~~~~~~~~~~~~b~b~~~b~~~~~~
~~~~~~~~~b~~~~~b~~~b~~b~~~~~~b~~~b~~~~~~~~~~~~bb~~b~~~~b~~~b~~~~~~~b~~bb~b~~~b~~bbb~b~~~~b~~~~b~~~bb~
b~~~~~~~~~~~bb~~~~b~~~~~~bb~~~~~~b~~b~bb~bb~b~~~~~b~~~~b~~bb~~b~~~b~~~~~~~~~~b~~b~~~~b~~~~~~~bb~~b~~~
~~~~~~~~~~~b~~~~bbb~b~~~b~~bb~b~~~bb~bb~~~~~~b~b~~~b~bbbb~b~~bb~~~~~~b~bb~bbbb~~~~~~~~b~~~~~bb~~~~~~~
~b~b~~~~~b~b~~~bb~~b~~~b~~b~~b~bbb~~~bbb~~~~~~~~b~~~~~bb~b~~~bb~~~~~~b~~b~bb~~~~~~b~b~~~b~bbb~b~b~~b~
~b~~b~~~bb~b~~~~~~~~~~bbb~~~~~~b~~b~~b~~~b~b~~b~~b~~~~~~~~~b~~~~~~b~~~~b~~~~~~b~bb~~~~~~~~b~b~b~b~~~b
~~b~~~~~b~~~bb~~~~b~~~~bb~~~b~~bb~bb~b~~bbbb~~~~bb~~b~bb~b~~~b~~~~~bb~~b~~~bb~~b~~~b~b~~~~~~~~b~~~~b~
~b~~b~~b~~~b~~b~b~~~~b~~~~~b~~~b~~~~~~~~b~~~~~~~~bb~~~~~b~~~~~b~b~~~b~~b~~bb~b~~~b~~~b~~b~~b~~~~~~~bb
~~~~bbb~~~b~~b~~bbb~b~~~~~~~~~b~~b~~b~~~~~~~b~~~bb~b~~b~~~~~~b~~~bbb~~~~~b~~b~~bb~b~~~bb~~~~~~b~b~~~~
~~b~~~~bb~~~~~b~~~b~~~~b~~~~~~~~bbb~~b~~~~~~~~~~bbb~~~~b~~~~bbb~~~~b~~~~~~~b~~~b~~~~b~~~~b~~~~b~~~b~b
b~~~~~~~~b~~~~~~bb~~~~~~~~~~b~~~~~bb~~~~~~bb~b~b~bb~~~b~~~~~~~b~~~~b~~~~b~b~b~b~~~~~~~~b~~~~b~~b~~bb~
bb~bb~b~~~~b~b~~~bb~b~~bb~~~~~b~~b~~~~~b~~~~~~~~~bb~~~~b~~b~~~~~b~~~~bbb~~b~~~b~b~~~~~~~b~~b~~~b~~~b~
~~~~b~~bbb~~~~~~~b~~b~~~~~~~~bb~~b~~bb~~~~b~b~~~~~~~~~~~~~~b~b~~~b~~bbb~~~~bb~~~~~bb~bbbbb~bbb~~b~~bb
~~b~~~b~bb~~~~b~b~b~~~bb~~~~~b~b~b~b~~b~~b~~~~b~~~~~~~b~~~b~b~~~~~~b~~bb~b~~~b~b~~~~~~~~~b~b~~b~b~~~b
~~~b~b~bbbbb~b~~~bb~~~~bb~~~b~~~~b~~~~~~~~~b~bb~~b~~~~~b~~~~~~~~~~~b~~~~bb~~~~bbbb~~bbbb~~~~~b~b~~~~~
~~~bb~b~b~~bb~b~bbbbb~~b~~~~b~~~b~b~~b~bb~~~~~b~~b~b~bb~~~~~~b~~~~~~~~~~~~b~~~~~b~~~b~~~~~~b~~~~b~~~b
~~~~~~b~~~~~b~~~~bb~bbb~b~~bb~~~~~b~~bb~~bb~~~b~~bb~b~b~b~~~b~~b~~~~~~~b~~~~~bb~~bb~~~~~~~~~~~~bb~~~b
bb~~~b~~~~~~~~~~~~~b~~b~~b~~b~~~~~b~b~~~~~~b~~~b~~~~~~~~~~b~~~~~~~b~~~~~~~~b~~~~~~~~~~~~~bb~b~~~~~~~~
~~~b~b~~~~bb~b~b~~~bb~~b~~~~~b~bb~~~~~b~b~b~b~bb~~b~~~bb~~~~~b~~b~~~~~~~b~~~~~~b~~~~bb~~~~~~~~~~~bbb~
~~~~~~~b~~~~~~~~~~b~~~~~~~bb~b~~~~b~bb~b~bb~~b~~b~b~b~~b~b~~b~~~~~~~~b~b~~~b~~bb~~~~~b~~b~b~~bbb~~b~~
b~~bbbb~b~~~~~~~~~~bbb~~~~~~bb~~b~~bb~~b~~b~~~b~~b~b~b~b~bb~~~~~~~bbb~~~bb~~~~b~~b~~~~~~bb~bbbbbbb~b~
b~~~~~b~~~~b~b~~~~~~b~~~~~~~~~~~~~~~~~~b~~~~~~~~~~~b~~bb~~b~bbb~bbb~b~~bbbbb~~~b~~bb~b~b~bbb~~~~b~~~~
~~~~~b~~b~~~~bbbbb~~bb~~~~~~~~~~~~~b~b~~~~~~b~~~~bb~~b~~~~~b~~~~bb~~~b~~~b~~~b~bb~~~~~~~bb~~~~~b~~~~~
b~~~~b~~b~~b~~~~~~b~b~b~~~b~~~bb~~~bb~bb~b~b~b~~b~b~~~~b~~~~~b~b~b~b~~b~~~bbb~bb~b~~~b~bb~~~~b~bb~bbb
~~b~bb~b~~~~~~~~~~~~~~b~~~~~~~~~~~~~b~~~~~~~b~~bb~~~b~~~~~~b~~bbb~b~b~~~b~~~~b~~~~~~b~~~~~~~~b~~~~b~~
~~bb~b~~~~bb~b~~b~b~bbbbbb~b~b~~~~~~~bbb~bb~bbb~~~~bb~b~~~~b~~~~~~bb~b~b~b~bb~~~~~~~~~~~~~~b~~b~~~bbb
b~b~b~~~~~~~~~~~~~bbbb~~~bb~~~~bb~~~~~bS~~~~~b~~~~~~~~~~~~b~~b~~~~~~~~~~~~~~~~~~~~~~b~~~b~~~b~~~~b~~~
~~b~~b~bb~~~bb~~b~b~~~~~~~~~~~~~~~~~~~bb~~b~~~b~~~bbb~~~b~~b~~b~~~bb~~~~b~~~b~b~~~~~~b~b~~~~~~~~~b~~b
~~~b~b~~~~~b~bbbb~~bbb~b~~~~bb~~~~~b~~b~b~bb~bb~~~~~b~b~~~~~b~~b~~~~~~~~~~~~~~~~b~~b~~~~~~~~b~b~~b~~~
~bb~~~b~bb~~~~~~~~~~~~~~b~~b~~~~b~bbbb~~~~~~b~b~~~~bbb~~~~~~~~bb~~b~~b~~~~~~bb~~~~bbb~~~b~~~~~~~bb~~b
~b~~~~~~~b~bb~~~~~~~~~~bb~~~b~b~b~~~bb~~~bbb~~~~~~~~b~~~~~~b~~bb~~b~~b~~b~~~~~b~b~~~b~~~~~b~~~~~b~b~b
~~~~b~b~~b~~~~b~b~~~b~~b~~~b~~bb~~~bbb~~b~~~bb~~b~~b~~~bb~b~b~~b~~~~~~~b~bbb~~~~~~~~b~b~~~~~~~~~~~~~b
b~~~~~b~~b~~bb~b~bbbb~bb~bbb~~~~~bb~~~~~~~~bb~b~~~~~b~~~b~~b~~~~~~~~~~~~~bb~~~~~~b~bbbb~b~b~~~~~b~~~~
~~~~bb~b~bb~bbb~~b~~b~bb~~~b~b~~~b~~bb~~b~bbb~~b~~~~b~bb~b~~~~~~~~~~~~~~~~b~~~b~~~b~bb~~b~~~~b~~~~b~~
b~b~bb~~~b~~~~~bb~bb~b~~bb~~b~~b~~bb~~~~~~~bb~~b~~~~~~b~~~b~~~~~~~bb~~b~~~~~~~b~b~b~~~bbb~~~~~b~~bbb~
~~b~b~~b~~~~~~~bb~b~b~~~~~~bb~bb~b~b~~~~~~~~b~~~bbb~~~~b~~~~~~b~~~b~~~b~~~~~bb~bbb~~~b~b~~b~~bb~~~~~~
~~~b~bb~~~~~b~~~b~~~~~b~~~bb~~b~~b~~~b~~~~~~b~bbbb~~~~~b~~~~~~b~b~~bb~~~~~~b~~~~~bb~bb~~~~b~~bb~b~~~~
~~bb~b~~~b~~~~~~~~~b~b~~~~~bbb~~bb~~bb~~~b~b~~~~~~b~~b~~b~~~~~~~~~~G~bb~~~~~b~~~bb~~~~bb~~b~bb~~~~b~~
~b~~~bb~~~b~~b~b~~~~b~~~~~~~~~~~bbb~~~~~~~~~~~~~~~~~b~~~bb~~~b~bbb~~bb~~b~~b~~~b~~~~~~~~b~b~~bb~b~~b~
b~~b~~b~~~b~~~~~~b~~~~~~bbbb~~~~~b~~~~~bb~bbb~~~b~~~bbb~b~~~~~~~~~~~~~~~b~~~~~~b~bb~~~b~~~b~~~~bb~~~b
~~b~bb~b~~b~b~~b~b~~~~b~bb~~~~bbbb~bb~~~~~~~bb~~~~b~b~~~~~~b~bb~b~bb~~~~~~~~bb~~~~~~b~~~b~b~~~~b~~~b~
~~~~~~b~b~~b~b~~~~~~~~~b~bbb~~~~~~~~bb~~~~~~b~~b~b~~~~~~~~~~b~~~~~~b~~~bb~b~~b~~~~b~~~~~~~~~~~~~~~~b~
~~b~~~~~~~~~~~b~~~~~~~~~~~~~b~~~~~~~~~~~b~~~b~~~~~~b~~b~b~bb~~~~~~~~~~b~b~~~~~bbb~b~~~~b~~~~~bbb~~b~~
b~bb~~~~bbbb~b~~~~~~~~bb~b~~~b~~bbb~~~b~~b~b~~~b~~~~~~~~~b~~b~~~b~~bbbb~b~~~~~b~b~~~~b~b~~bb~~~bb~~b~
~b~~~bb~~~~~b~b~b~~~~~~b~~~~~~~~~~b~~~~bbb~~~~b~~~~~bb~~~~b~~~~~~b~~bbb~~~~b~~bbb~~~~~~b~~~b~~~~~~~~~
~~~~~~b~b~~~~b~~~b~~~~~~~b~~~~bb~~~~~~b~b~b~b~~~~~~b~~bb~~~~~~~~~~~~~~~b~b~~~~~~b~~~b~b~b~~~~~b~~b~~~
b~~~~~~~~~~~~b~bb~~~~~b~~b~~b~b~~~bbb~~bbbb~~~~~~bb~~~~~b~b~b~~b~~~b~bb~~~~bb~~~b~~b~b~b~~~~~~b~bb~~b
bb~~~~~b~~~~b~b~~~b~~~bb~~b~~~~~~~b~b~~~bb~bb~~~~~~~b~~~b~b~~~~~~b~b~~bbb~~b~~~~b~~b~b~~~~~~b~bb~b~b~
b~b~~~~~~b~~bb~~b~b~~~~~bb~b~~~~b~~~~~bbb~~~b~~~b~~~bb~~b~~~b~~~~~bb~~bb~b~b~~~bb~~~~b~~~~~b~~~~b~~b~
~~b~~~~~~~bbb~b~~bbb~~~~~bb~~b~b~~~b~~b~~~b~~~b~~b~b~~b~~~~b~bb~~~b~~~~~b~~b~~~~~~~~b~~~~~~~~~b~~~~~~
~~~~~b~~bb~~~b~~~~~~~bbb~~b~~~~~~~b~~~~~~~~~b~~~~~~b~~~~~b~~~~~~~~b~~~~~b~~b~~~~~~~~bb~~~~b~~~~b~~~~~
b~b~~~~b~b~~~~~~~bb~~b~~b~~~~~~b~b~bb~~~~b~b~~~~~bb~~~~~~~b~~~~~~~b~~~~~~~b~b~~b~b~~~~~~~~~~~b~~b~~~~
b~~~bb~~~bb~~bbb~b~~~~bb~~~bb~~~~b~~b~~~~~bb~~~b~~~~~~b~~~b~~~b~~~~~~bb~~~~~~~~~~b~~~~bb~~~~~~bbb~~~b
~bb~~b~~~bb~~~~b~b~~~~bbb~~b~~~~b~b~~b~~~b~b~b~~b~~~~b~b~bb~b~~~~~~~~bb~~~~~~~~~b~~~b~b~~~b~~b~~b~~~~
~~~~b~~bb~~bb~~~~~bb~b~b~bb~~~~~bb~~bbb~~~b~~~bbb~b~~bb~~~~b~~~~b~b~~~~~~~b~~~~~~~~~~bbb~~~~~~b~~~~~~
~~~b~~bb~~b~~~b~~~~~~~~bb~bb~~~~bb~~b~~~~b~~b~~b~~~~b~~~~~~~~b~~b~~~~b~b~b~~~~~bbb~~b~bb~b~bb~~~~~b~b
~~~b~b~~~~~bb~~~~~~~b~~bb~b~~~~~~~~~b~~~bb~b~bbbb~bbb~b~b~~~~~~~b~~b~~~~~~~b~~~~~bb~~b~b~~bb~b~~b~~b~
~b~b~~~~~~bbb~b~~~~~~~~b~~~bb~b~~bb~~bb~~~b~~~~b~~~bb~~~~~~b~~~b~~~~b~~b~~~~b~~~~~~~~b~b~~bb~~~~~~~~b
bb~~~~~~~~~b~~~b~bb~~~bb~b~~~b~~~~~bbb~bb~~~bbb~~~~~b~~~~~~~bb~~b~~~~~~b~~~~b~b~~~~b~~~~~~~~~~~~b~bb~
~~~b~~bb~b~~~~~~~b~~bb~~~~~~bb~bb~~~~~~~~bbb~b~bb~~b~b~~~~~~~~bb~~b~bbbb~~~~~~~~~~~~~bbb~~~bb~bb~~~b~
~b~~b~~~~~bb~b~~~~~~~~~~bbb~~~~b~~~~~~~bb~~b~~~~~~~~~bb~~bbbbb~~bb~b~~~~~~b~~~~~b~~~b~~~b~bb~b~~b~~b~
b~~~~~~~~~b~b~b~~~~b~~b~~~~~bbbb~~~~~~b~~~~~~~b~~~b~~~b~~~~~~~~~~~~~b~~~b~bb~~~~~~~~b~~~~~~~~~~~~bb~~
~~~~b~~b~~~~~~b~~b~~~b~~~~~~~~~~~~~~~~b~~b~~bb~b~~b~~~~b~b~b~~~~bbb~~~~bb~~~~b~bbb~b~~~~~b~~~b~~~~bb~
b~~~b~~~~~b~~bb~b~b~~~~~bbb~~~b~~~~~~~~bb~~~bb~~bbb~~~bbb~~~~~~~b~~~bb~~~bbbb~~b~~~b~~~~~~~~b~~~~bb~b
~b~~~~~b~~~~~~~b~~~b~b~~~b~~~b~bb~~~~~~~b~~bb~~bb~~b~b~~~~~~~~~~~b~~~~~b~bbb~~~b~~~~b~b~~b~b~~~~b~~~~
bb~~~~b~bb~~~~bb~~~~~~~b~~b~~b~b~~~~b~~b~b~~b~~b~~b~~b~~~~b~~bb~~b~~bb~~b~~~~~bb~b~~~~~~~b~~bbb~~bb~~
b~~b~~~b~b~~~~b~~~~~~~~~b~bbbb~~b~~~~~bb~b~~~~~bb~bb~b~b~~~~~~~~~b~~~~~b~~~~~~~~~bb~~~b~~b~~~~~~~bbb~
b~~~~b~~bbbb~~~~~~~~~~~~~~b~~~~~~~~~~~~~~~~~~~b~~b~~b~b~bb~~~~b~~~~~~~bb~~~b~b~~~b~~b~~b~bbbb~~b~~~~~
bbb~~~~~~~~~~~~~~~~~~b~b~~~~~~~~b~~b~~~b~~bbb~~~b~bb~~~b~bb~~~b~~~b~~b~~b~b~b~~~~~~~b~~~~~~b~bb~~~~~~
bb~b~~bb~~b~~~~b~~~~b~~b~~~~~~~~b~~b~b~bbb~~~~~~~~~~b~b~~b~~b~b~~~bbbb~~b~~~~~~~~b~~~~~~~~~~~~~~~~b~~
~bbb~~b~~bbbb~~~~b~b~~~~~b~~bb~~b~~~b~~~~b~~bb~~~~b~~~~~~~bb~~~~~~~~~~bb~~~~~~~~bb~~bb~~~~b~~~~~~~~b~
~~~b~bb~~b~~~b~~bb~b~bbb~~~bb~b~~~~~~bb~~~~b~~bbbb~b~~~bbb~~~~bb~~~b~~b~b~~~~~~~b~bb~~~~~~~~bb~~~~b~~
b~~~~~b~bbbb~b~~b~~~~~~~b~~~~b~b~~~~bb~~~~~bbb~~~~~bb~~~bb~~b~~~~~~b~b~~~~~bbbb~~~~~~~~b~~~~b~~~b~~~b
~~b~b~~~~~~~~~~b~~~~b~~b~~~~~bb~b~~~~b~~bb~~~~b~b~~~~~bb~~b~~~b~~b~~~~~~~~b~~~~~~~~~~~~~~~~~~b~b~~~~~
~~b~~b~bb~~~~~~~~b~bb~~~~b~b~~~b~b~~~~~~~bb~~b~~b~~b~b~~b~b~~~b~~~~~bbb~~~bb~~~~~b~b~~bb~bb~b~bb~~~~~
