~~b~bb~~b~~~~~b~~~~bbb~~bb~bb~~~b~~~b~~~~~~~~bb~~b~~~~bb~~b~~bb~~b~~~bb~~~~~~bb~~~~~b~~b~b~~b~~~~~~~b
~~~~b~~~~~bb~~b~~~bb~b~b~~~b~bb~~~bb~~b~~~b~b~b~~b~b~b~bb~~~bbb~~~~~~~~~~~~bb~~~~~~~b~~~~~~~~~~b~~~~~
~bb~~~~~~~~~~~b~~~b~~b~b~b~~~b~~b~~~b~~~b~b~~b~~bb~bbbb~~~~~bb~b~~~~~~~~bb~~~bbbbb~bb~~~~b~~~~~~b~b~b
~b~~~~b~~bb~~~~~~~~~~~~~~~~bb~~~~~~bb~~~b~bbb~b~b~~bbb~~~~~b~~~~~b~~b~~b~~~~~b~~b~~b~~~~~~~~b~~~~~b~~
~bb~~b~~~b~~~~~~~~~~b~~~~b~~~~bb~~b~b~b~b~~~~~b~~~~~~b~~b~~~~~b~~~~b~b~~~~bb~~b~b~~~~~~b~~~~b~~b~~b~~
b~~~~~~~~~~~b~~b~~~b~b~~~~bb~bbbb~~~b~~~~b~b~~~b~~b~~~~~~~b~b~bb~bb~~~~bb~~bbb~~~~~~~~~~~~b~~b~~~b~b~
bb~bbbb~bb~~~~~b~b~~~~~~~~b~~~~~bb~~b~b~b~b~~~~~~~~b~~~~~b~~~b~~~b~~~bb~~~~b~~~~~~~~~~~~b~~~~bbb~~~~b
~~~~~~~~~~~~~b~~~~~b~b~~b~~~~~~~~~b~bb~b~~~~b~~~~bb~b~~~bb~~~~~~~~~~bb~bbb~~~~~~b~b~b~b~bbb~~bb~bb~~~
~~~~~bb~~~~~~b~~~~~bb~~~b~~~~~bb~b~~bb~b~bb~~b~bb~~~~b~~~~~bb~~b~~~~~bbb~~b~~b~~~b~b~~~~~b~b~bb~~~~~~
~~~~~b~~~~~~~~~~b~~~bb~~~~~~bb~~~~~b~~~~~b~b~~~b~~~~b~b~~b~b~b~b~~~~~~~~~~~~b~b~~~~b~~~~b~~~b~~~~b~~~
b~b~~~~~~~~~~b~~~~~~bbb~b~b~~~~~~~~b~~b~bbb~b~~~~~b~b~b~~b~~b~~bb~~b~~~~~~bbb~~~~~~bbb~~~~~~~~b~~~~b~
~~~~b~b~~~~~b~~~~~b~b~bbb~~~~~b~~~b~~~b~~~~bb~bb~b~~~~~~b~~~~~~~~~~~~b~~~~~~b~~b~~~~~~~~~bb~~~~~b~~~b
~~b~~~~~~~~~~~bb~~~~b~~bbb~b~~~~~~b~bb~~~~bb~~~~~b~~~~~~~~~~~b~~~b~b~~bb~~~~b~b~~~~~~~~bb~~b~~~~~~b~~
~~~~bb~~~~~b~~~~b~~~~~~~b~~b~~~b~b~~bb~~~bb~b~~b~bb~bb~~bb~b~bb~~b~~~b~~~b~b~~~b~~~~b~~b~bb~b~~~~~bbb
b~~bb~bb~~~b~~~~~~~~b~bb~~bb~~b~~~~b~~~~~b~b~b~~b~~b~~~~b~~~~~b~~b~~~b~~~b~~~~b~~~~~b~~~bb~b~~~~~~~b~
~~~~~~~b~~b~~~b~~~~b~~b~~~~~b~~~~b~b~b~~~~b~~bbb~~~~~b~~bb~bb~b~b~b~~b~b~~~~~~~bbb~~~b~~~~bb~b~~~~~~~
bb~~b~~~~~~b~~b~bb~b~~bb~bb~~~b~~~b~b~~~~bb~bb~~~~bbb~~b~~~~~~bbb~~~~~b~b~b~bb~~~~~~~~b~~bb~b~~~bb~~b
b~b~~~bb~~~~~~~~~~bb~b~b~~b~~~~b~~~b~~~~~b~~~~~~~b~~~~b~~~~~~~~~~~b~~b~~~~b~~~bbbb~~~~bb~~~~~~~~~~~~~
~~~~~~~~~~~~b~bb~b~bbbb~b~b~b~b~~~~~~bb~b~bbbb~~b~~~~~~~~~~~~~bb~~~~~~~~b~b~~~~~~~~~~~~b~~~b~b~~b~~~~
~~~~bb~~~~bb~b~~~bb~bb~b~~~~~b~b~b~~b~~~~~~~b~~~b~bb~~~bb~~b~~~b~~~~b~~~b~~~~~~b~~~~~~~~~b~b~bb~b~~~b
~~b~~b~~~~b~~~b~bb~~b~~~~~b~~~~b~~~~~b~~~bb~~b~~bb~~~b~~b~~~~~bbb~~~b~~b~~~~~~~~~~~~~b~~bb~~~~~b~~~bb
~~bb~~~bb~~b~~~~~b~b~~~~~~b~~~~~b~~b~~~~b~b~~~bb~~b~~~~~~~~bb~bbb~b~~~~~~b~b~~~~~~~b~~~~b~~~~b~~b~~bb
~~bb~~~bb~~~~~~~b~~~~b~~~~b~~~~~~b~bb~~~~~~~b~~~~~b~~~~b~b~bbb~~~~~~~bb~~~~~b~~b~~bb~~bb~~~b~~~~~~~~~
~b~~bbb~~~~~~~b~~~~~~~~~~~~~~~b~~~~b~b~bb~~~~~b~bb~~~b~b~~~b~b~~~~~~~~~~b~~b~bb~~bb~~~~b~~~~~b~~~~~~b
~b~~~~~~~~~~~b~~~~~~~~~~~~~~~~~~~b~~~~b~~b~~b~~~b~~~~~~~~b~b~~~~~~~~~~~~b~~~~~~b~bb~b~~b~~~b~~b~~b~b~
~~~~~~b~b~~~~b~bbb~~~~~b~~b~~~~~~~bb~~~~~~~b~~b~bbbb~~~b~~~~b~~~~~~bb~~~~~~~bb~~~b~~~b~~~b~~b~~~bb~~~
b~~bb~~~~~b~~b~~~~bb~~b~~~~~~~~~~~~~~bbb~~~b~~bbb~~~b~~~~~~~b~b~b~~~~~~b~~b~b~~~~b~bb~b~~bbbb~~~~~~~~
~bb~~~bb~b~~~b~~~~~b~~~~~~~~~~b~~~~~~b~~~bb~~~~b~~bb~~~~~~b~~b~b~b~~~~bbbbb~~b~~~~b~~~~~~~~~~~b~~bb~~
b~~~~b~~~~b~~~~b~~bb~~~~~~~~~bbbb~b~b~~b~~b~b~~b~~~b~~~~~~~bb~~~~~bb~b~~~b~~~~~~~b~~~~~b~~~b~~bb~~b~b
~bb~~~bb~b~~b~b~~b~~b~~b~~b~~~b~bb~~~~~b~b~~b~~~~bb~~~~~~~b~~bbbb~~bbb~~b~bb~~b~~~b~~~b~~b~b~b~~~~~bb
~b~~~~~~~~bb~bb~~~~b~~~~bb~~bb~~b~~b~~~~~~~~~~~~~~~~~~~b~bb~b~~~~~bb~~bb~b~~~b~~b~~~~b~~b~bb~~~b~~~b~
b~~~~~bb~b~~~b~~b~~~~~~~~~b~~~b~~~~~b~b~~b~~~~~bb~~~bbb~~b~~~~~~bbb~~~~b~~~~b~~~~b~bb~b~~~~~b~b~~~bb~
~~~~b~~~~~~b~~~~bb~b~b~~bbb~~~~~~~b~~~b~~b~b~~~~b~~~~~b~b~bb~~b~b~~~~~~~b~~b~bb~~~b~~b~~bb~~b~b~b~~b~
b~b~~~~~~~~~~b~~~~~~~~~b~~bb~~~~b~~~~~~~~~~~b~~bb~~b~~~~~~~~~b~~~b~~~~~~b~~~~~b~~~~b~~~~bb~~b~b~~~bb~
~b~~~~~~~~~~~~b~~b~~b~~~~b~~~b~~~~~~~~~bb~~~~~~~~b~bb~~~~~b~~~~~~~b~bb~~~~b~~~~b~~~b~~b~~b~~~~b~~~~~~
b~~~~~b~bbbb~~bb~~bbb~~~~~~~~~~~b~~~bbbbb~~~~~b~b~~~~~~~~~~~~bb~b~~bb~~bb~b~~~~~~b~~~~b~~~~~bbb~~~~~b
b~~~~~~~~~~b~b~b~~b~b~~~~~~~b~~~~~~~~~~~bb~~~b~~~b~~~~b~~~~~~b~bbb~b~~~~~~bb~~b~~~~~~~~~b~b~~~~bbb~b~
~~~~~~~b~b~~~b~b~~~~~~~bb~~~~b~~~~~~~bbb~~~~~~~~b~~~~~~~~b~~~b~~~b~b~~b~~~bbbb~b~b~b~~~bb~~~~~~~b~~~b
~~~b~~bb~~b~~b~~bbbb~~~~~~~~b~b~~~~~~~b~~~b~~b~~~~~b~b~~b~~bbbb~b~b~~b~~b~bb~b~b~~b~b~b~~bb~~~~~~bb~b
~b~~b~~~~~b~~b~~~~~~~~~~~~~~~~~~bb~b~b~~~b~~~~~b~~~~b~~~bb~~~~b~bb~~~~~~~b~bb~~~~~~~b~b~b~b~b~~~~~~~~
~~bb~~bbb~~~~~~b~b~~b~~~~~~~b~~~~~~~~~~~bb~b~b~b~~~b~b~~~~~~bb~~~~~~~~bb~~~b~~~bbb~b~~b~~bb~~~~bb~~bb
~~~~~b~~~~~~b~b~b~~~b~~~b~bb~b~~~~~b~~b~bbbb~~b~~~~~~bbbb~~~b~~b~~bb~~~~~~~~~~~~~~~~~~bb~b~~~bb~~b~~b
~~~~~b~~b~~~~b~~bb~~~bb~~b~~~b~~~~~~~~b~~~b~~~~~~~~~~~bb~bb~~~b~~~~~~~b~~~~~bb~~~~~b~~b~~~~~~b~~bb~~b
~b~~~~~b~b~b~~~~b~bb~~~~~~~b~~bb~bb~~~b~bb~~~~~~~~~b~~~bb~~~~b~~~~~b~~~~~~~~~~~~~~b~~~b~~bb~~~~b~~b~~
~~~b~b~~~~~~~~b~~~~~~bb~~~~b~b~~~~~~b~~~~~~bbb~b~b~~b~~b~~~~~b~~~b~~~b~bbbbbb~b~~~~~~~b~~~bb~~~~~~~~~
~~~~~bb~b~b~~~b~~~b~b~~~~bb~~~~~~b~b~~~~~b~bb~b~b~~~~b~~~~~~~b~~bb~~~~~~~~~b~bb~b~~b~b~bb~~b~~~b~~~~~
~b~~b~b~~~~~~~b~~~b~~b~~~b~~~~b~~b~~bb~bb~~~~~~~~~~~b~~bb~b~~~~b~~b~~~~b~b~~~~~~~~b~b~~~b~b~~~~~~~~~b
~~~~~b~~~~~b~~bbb~~~~b~bb~~~~~~~~~~~b~~b~~b~~~b~~~~bbb~~~~~~~b~~b~bb~b~bb~b~~bb~bb~b~~b~~bbb~~b~~~bb~
bb~~~b~~~~b~b~~~~~b~b~~~b~~~~~b~~b~b~~~~~b~~~bbb~~~~bbb~bb~~~~~~b~~~~~~b~~~~b~b~~bb~~~b~~b~~~b~~b~~~~
bbbb~~~~b~~b~bbb~~~~~~~~~~~~~b~~~~~~b~~~~~bb~b~~~~bb~~~~~~~~~~~b~~~~~~~~b~~~~~~b~bbb~~~~~~b~~~bbb~~~~
b~~~~b~bb~b~~~~b~~b~bb~~~b~~~~~b~~b~~b~~~~~~b~~~bb~~b~~~b~~~~~~~b~~~~~~~~~~b~~b~~~~~~~~~~b~~~b~b~~~~~
~~~~b~b~~~~~b~b~~~b~~~~~~bbb~bb~~~b~~b~~~~~~~bb~b~~~~~~~~~~~b~b~~~b~b~~~~~~b~~~~~bb~b~b~~b~~~~~b~~~~~
b~~~b~~~b~~~~bbb~b~bb~~~~b~b~~~~~~b~~bbb~bb~~~b~~bb~bbb~~~~b~~bb~b~b~b~b~b~~~bb~~~b~~~~~~~~~b~~~~~~~~
bb~~~b~~~~~~~~~~~~~~b~~~~~~~~~~~~b~~~~~~~~~b~b~bb~~~~b~bbb~~b~b~b~~b~~~~~b~~~S~~~~~bbb~~b~b~b~~b~b~~b
~~~~~~b~b~~b~~b~~~b~~~~b~~~b~~bb~b~~~~~b~~b~~~~~~~~~~~~~b~~~~~~~b~~b~b~b~~~bbb~b~~~~~bb~~~~~~~b~b~bb~
b~~~~~~~~~~~~b~bb~~~b~~~~b~~b~~b~~~b~b~~~~~~~~~~b~~~~~bbb~~~bb~~~~~~~~b~~b~~b~~~~~b~~b~~b~~~~~~~~~~~~
~~bb~bb~~b~~~b~~~~bbb~bb~b~~~~b~bb~~~b~~~bbb~~~bb~~bbb~~b~~~~~~~bb~~~~b~b~~~b~~~~~b~bb~~~b~b~~bb~~~b~
b~~~~bb~~~b~~~~bbb~~~bbb~~~~~~~~~~~~~~~~~~~bb~b~b~~~~b~~~bb~~~~~~b~~~b~b~bb~~~b~~b~bb~b~~b~bb~bbb~b~~
~~~~~bbb~~bb~~b~~~~~~~b~~~b~~~~b~~~~bb~~~bb~~~~bb~bb~~~~b~~~bbb~b~~~~~~~~~~~~~~~~b~~~~~bbbb~bbb~b~~~~
~~~~~bbbb~~~b~b~b~~~~b~~~~b~~b~~~~~b~~~~~~~b~~~~bb~b~bb~~~~~~~b~b~b~~~~b~~b~~~~bb~~~bb~~~~~~~b~~~~~b~
b~~~~b~~~b~~~~b~~~~bb~b~b~~b~~bb~~~~~~b~b~~bb~b~~~bb~~~~~~b~bb~~~~~~~~bb~~~~~~~~b~~~~~bbb~~b~~~b~b~b~
~~~~~~~~~~~~~b~~~~~~~~b~~~~~~~~b~~~~~~bbb~b~~~b~~~~~~~~bbbbb~~b~~~~b~~~~~~b~~~bb~~bbb~b~bbb~~b~b~~bb~
~~~~~~~b~~~~~~b~~b~~~~b~bb~~b~~~~bb~b~~bbb~~~~b~~~~~b~bb~~~~b~b~~~bb~~~b~~~~~b~~~~~~~~~~~~~bbbbb~~~b~
b~~~~b~~~~~~bb~~~~~b~~~~~~~~~~~~~~~~bb~~~~~~b~~bb~~~b~~~~~~~~~~~~~b~~b~~b~b~b~~~b~~~~~bbb~~bb~~~~~~~~
~~b~~bb~bbb~b~bbb~bb~~~~~bbb~~b~~b~~~~b~b~~~~b~~~b~~b~~~bb~b~b~b~~~bb~~~b~~bb~~b~~b~~~~~~~~b~~~~~b~b~
~~bb~~~~~~~~bb~~~~~~~b~~~~b~~b~~~~~~~b~~~b~~~bb~~b~~~~~b~~~bb~~~~~~bb~b~~~b~bb~~bb~b~~~~b~~b~b~bbb~~b
bb~~~b~~~~~~~~~~b~~~~~~~~b~~b~~~~b~~~~~~bbb~~~~~b~~~~~~~~bb~~~bbb~~~b~bb~~~~~b~~~bb~~~~b~~~b~bbbb~~~~
~b~~~~b~b~~b~~~b~b~~~~~bbb~b~bb~~~~~~~~bb~~~bb~~~~~b~~~~b~~~~~~~~~~~~~~~~~~~~b~b~b~~~~b~bb~b~~~~~b~~~
bb~~~~~b~~~b~b~~~~~~bbbbb~~~bbbb~bb~~~b~~~b~~~~~~~~~~bb~~bb~bbb~~~b~~~b~bb~~~b~b~~b~bb~~~~~bb~b~~~b~~
~~~~b~~b~b~~~~~~~b~~~~~~b~~b~~~~~~~b~~~~~~~~~~b~~~~~~bb~~bb~~~~~~bb~~~~~~~~~~bb~~b~b~b~~~~b~~~~~b~~~b
bb~~~b~b~~~~~~~bb~~b~b~~~b~~~~b~bb~b~~b~~~~~~bbb~b~~bbbb~~bb~~~~bb~b~~~~~b~~b~~~bb~~~b~b~~~~~~b~b~~~~
~b~~~~~b~~~bbb~~~~b~b~bb~~~~b~~~b~~~bb~~~~~b~~~~~bbb~~~~~~~~~b~~bb~b~~~b~~~~~~~~~~bb~b~b~~bb~~~~~~~bb
~b~bb~~~~b~~~~~b~b~b~~b~bbb~~~b~bbb~~~~~~~~bb~~bb~~b~~~~~~b~~~~~~~~~~bb~b~~b~~b~~~~~~~~~~~~~~~~b~bb~b
~~~~~~~~~b~~~~~~~~~~b~bb~~~~~~~b~~~~b~b~bb~~~~~~~b~~~~~~~~~~~b~~~bbb~~~~~~~~b~~~~~~~b~b~~~b~b~b~~~b~~
~~b~~~~bb~~~~b~~~~~b~~b~~~~~~~~b~~~b~b~~b~~~~b~b~~bbb~b~b~b~~~~~~~bb~~~bb~~~~~~~~~~~~~~bb~~~~b~~b~bbb
~b~b~~~b~~bb~b~~b~~~~~~~b~~~~b~~~~~~~b~~~~~~b~bbb~~~b~~~b~~~~b~~~bb~~~~bbb~~~bb~~~~~~~~~~~~~~b~bb~bb~
b~~~~~~~bb~~~~b~~bbbbb~bbb~~~~~~b~b~~b~~b~~~b~~~~~b~b~b~b~~~~~~bbb~bb~~bb~b~~~~b~b~~bb~~~b~~~b~~b~~~~
~~~~~b~b~~~bb~~b~b~~~~~b~~~~~~~~~~~~~~b~~b~~b~~b~~~b~~~~~b~~~b~~~~~bb~~~~~~b~~b~~~~~~~~~~b~~bbbb~~b~b
b~~b~~~~~~~b~~bb~~~b~~~~b~b~~~~~~~~~b~b~~~~bb~~~~~~~~~~~b~b~b~~~~~~~~~bb~~bb~b~~~~~~b~b~b~b~~~~b~~~b~
b~bb~~~~~~~b~bb~bbbbb~~~~b~bb~~~~~~~~~~~~~~~bbbb~bb~~~~~~b~bbbbbb~~~~~b~~~~bb~~~~~~~b~~~~b~~~~~~~~~~b
~~~~~~~~bb~bb~~~~~~b~~bb~~bb~~~bb~~~~~~~~~~~~~b~~b~~~~~~bb~~b~~bb~~~~~b~~~~bb~~b~~~bb~~~~bb~b~~~~~~~~
~~b~~~~~~~b~~~~b~~bbb~b~~~~~~~~~~b~b~~b~~~~~~~~~bb~~b~bb~~b~b~~b~b~~~~~~~b~~~~b~b~~~~b~~~~~~~b~~~~~bb
~~~~~b~~b~bb~~bbb~~b~b~b~~~~~~~~~~~b~b~b~~~~~bbb~b~~b~~~~~~b~~~~~~~~~~~~~~~~~~~~bbb~~~~bb~~b~~b~~~~~~
bb~~~~b~~~~~~~~~~~~~~b~bbb~~~b~b~~b~~~~~~~~~b~~b~b~~~bb~~~b~b~~~bb~b~~~~~~b~b~b~~~~~~b~bb~~bb~~~b~~~b
~b~~~~b~b~~b~~~~~~~~~bb~~~b~~~b~~~b~~~b~~~~~~~b~~b~~~~b~~~b~bb~~b~~~~b~~b~~~~~~~~~bbb~~~~~~~~~~~~~~~~
b~~~~~~~~~~~~~b~~~b~~~~~~~~~~~~~~~b~bbb~bb~bb~~~~~~bb~~~b~~b~~b~~~~~bbb~~~bbb~~~~~bbb~~~~~~~~~~~~~b~~
~~~~~~~~~~bbbbb~~~~~~b~~bb~~~~bb~~~~~~~~~b~b~~~b~~b~b~~~b~~b~~bb~~~~~~~b~bb~~~b~~~b~b~~b~~b~b~~b~~b~~
b~~bb~~~~~~~b~b~b~~~~~bb~bbb~bb~bbb~~b~~~~~~bb~~~~~bb~~~~~~b~~~~~~~~b~~~~~~bbbbbbb~~~~b~b~~~~b~~~bbb~
b~~~~~~~b~~~~~b~~b~~b~~~~b~b~~~~bbb~~~~~bbbb~~bb~b~~~~bbbbb~~~~b~bb~~~b~~b~~~~b~b~~b~~~~~b~~b~~~~b~~~
bb~~~~~~~~b~b~~~b~~~~~b~~b~b~~b~~bbbb~~~~b~b~bbb~b~~~bb~~~~~~~~~~~~~~b~~~~b~~~~~~~~~~b~~~~~~~~~~~~~~~
b~~~~~~b~~~b~~~~~b~~~~~~b~~b~b~~~~b~b~~~~~~b~~~b~b~~~~~~~b~~~b~~b~~~~~~~~b~~b~~~~~~~~b~~bb~~b~~b~bbb~
~~~b~~~~~~bb~b~~~b~~~b~~~bb~b~~~~~~~~~~~bb~b~bb~~~b~~~~~~b~bb~~~~b~~~~bbb~~~~~~~~~~~~~~~~~~b~b~~~~~~~
b~~b~~bb~b~~b~bbb~~b~bbb~~~~b~b~~b~~b~~~~bb~~~~b~~~~b~~~~~~~bb~~bb~~~b~~b~~~~~~bb~~~~~~~b~~b~~~b~~~~~
~~~~~b~~~~b~~b~~~~~~~~~~~bb~~b~~~~~~~b~b~~~~~b~b~~bbb~~~~~bb~b~bbbb~~~~b~b~~~~~~~~~~~~~~b~~~~~~~~~~bb
b~~~b~~bb~~~b~~b~~bbb~~~~b~~~~~b~~~~b~~b~b~bb~~~b~~~~~~~~bb~~bb~~~~G~b~bbb~~~bbb~b~~~~b~~~~~~~~~bbb~b
b~~~~b~~~~b~~~bb~~~~bb~~~b~~~~b~b~~~~~b~~~b~~~b~b~~bbb~~~~~~b~~~~~~b~bb~b~b~bb~b~~~~~b~~~~b~~b~~~~~~b
~b~~~b~~~~~~~~b~~~b~~b~~~~~bb~bb~~~~~b~~~~b~~~b~~b~b~b~~b~b~~b~b~~~bb~~~~~bb~~~b~~~~b~~~~~b~~~~~b~~b~
b~~~~~~b~b~~~b~~~bb~~~~bb~~~~b~bbbb~~~bbb~~bb~b~~~~~~~~~~~~~~~~~~~b~b~b~~~b~~b~~b~~~~b~~~~bb~b~~bbb~b
~b~~~~~~~~~bbbb~~~bb~~b~~~~~bbbbb~b~~b~~~b~~~~b~b~b~~~bb~~~~~~~~~~b~bb~bbb~~~~~b~b~~~~~bbb~~~~~~~~~~~
~~~~~~~~~b~~~~~~~b~~~bb~~~~~~~~~~bb~~~b~b~b~~b~~~~bb~bb~~~~~bb~b~~b~~~b~~b~~~b~~~~~b~~~~b~b~b~~~b~bb~
bbb~~~~~~~b~~bbbbbb~~bb~~b~~~~b~~~~~bbb~~~~bbb~b~~~~~~~~~~bb~b~~~~~~~~~b~~~b~b~b~~b~~~b~~~~~b~bb~b~b~
