b~~b~b~~b~~~~b~~b~~~~~~~b~~b~~~~~bb~~~~b~b~~~b~b~~~~b~~~~~~~bb~~bb~bb~b~~~~bb~~~b~~~~bbb~~b~bb~bb~~~~
~~~~~b~~~~~b~~~~~bb~~~~~~bbbb~bb~~~~~b~~b~b~~~~~~b~~~~b~~~~~~~b~~~b~~~~~b~~~~bb~~b~bb~~~~~~bb~~~~~~b~
~~~bb~~~~~~~~~~~~~b~~~~b~b~~~b~~~bb~~~bbbb~~~~~b~~bb~~~~~~~~~bb~~~~~b~~~~~~~b~~b~~~~~b~~~b~~~b~bb~~~~
b~~~~~~b~~bb~~~~~~~~b~~~~~~~~~~~~~~~~~~b~bb~~~~~~bbbb~b~bb~~~b~b~bb~~~b~~b~~~~~b~~~~b~~~~b~~~~~~~~~~~
bb~~b~b~~b~~b~~~~~~~~bb~~~bbb~~bb~~b~~~~bbb~b~~~~~b~~~~~~~~~bbbb~~~~~~b~~bbb~~bb~~~~~~bb~~~b~~~b~~~~b
~~~~~~~bbb~~~~~~bbb~b~~~~~~b~~~~bb~b~~~~~~~~bb~~~~~~b~~~b~b~~b~~~b~b~~~~b~b~~b~b~~bb~~~~bb~~~~~bbbb~~
~~~b~~bb~~b~b~b~b~bb~~b~bbb~~bb~~b~b~~~~~~~~~~~b~~~b~~~~~~~b~b~b~bb~b~~bbb~bb~~b~~~~~~~~~~~~~b~~~~~~~
b~~~~bb~~b~b~~b~~b~~b~~b~~~b~b~~~b~~~~b~~~~~b~~b~~~~~b~b~bb~b~~~~b~b~~~~~~~b~~~~~~~~~~~~b~~~b~~~~~b~~
b~~b~~~~~bb~b~b~b~~~~~bbb~~~bb~~~b~~~~~~~~~~~~~~~~~b~b~b~bb~~~~~b~~b~~~bb~~~~~b~~~b~~~~~~~~bb~b~b~b~~
~~b~~b~~bb~~~~~~b~~~bb~~~~~~bb~b~~~b~~b~~b~~~~~~~~~b~~~~bb~~b~b~~~b~~~bb~b~~~b~~~~b~~~~bbb~~~~~~~~~b~
bbb~~~~~~~~bb~~b~~~~~~~~b~~bb~~b~b~~~b~~~~~b~~~~b~b~~b~~~~~~b~bb~b~~~~~~~~~~~~~~b~~~~~~b~~~~~~~b~~~~b
b~b~~bbb~~~~bbb~b~~b~~b~~~~~b~~~b~~~b~~b~bbb~~~b~~~~b~~~~~~~bb~~~b~~~~~~~b~bb~~~~~~bb~~~b~b~b~~~b~~bb
~~~~b~~b~b~b~~b~~~~~~~b~b~~bb~~bb~~~b~~b~~~~bb~~~~~~b~bb~b~~~b~~b~~bb~b~~b~~~~~bb~~~~bbbb~~b~b~~~~b~~
b~~~~~b~~bb~~~b~~bb~b~~b~~b~b~~~~~~~b~~~~~~~~~b~~b~~b~~~~~~b~b~b~bb~b~~~~b~~~b~~~bbb~b~~~~~~~~b~~~b~b
~b~~~b~~~~b~~~~~b~~~~~b~~~~~~~b~~~b~~~~~~~b~~~~~~~~~~~~~~~~~b~b~~b~b~~b~~~b~~~~b~~~~b~~~~~~~~b~~~~b~~
b~~~b~~bb~~~~~~~~b~b~~~~~~b~~b~bb~~~b~b~~~~~~b~~~b~b~b~~~~~~~~~~~~~~b~~bbb~~~bb~~~~bb~b~~~b~~~~~~~~~b
~~~b~~~~~~b~b~~~~b~~~b~~b~~~b~~~~~~~~~~~b~~~~~~~~b~~~~~~~b~~~~~~~~~~~~b~b~~~b~~b~~b~b~~~~~b~~~~~bb~~~
~~~~~~~~~~~~~~~b~b~b~~~~~~~~b~b~~~~~~~~~b~~b~~~~~bb~~~~~b~~~~b~~~bb~~~~bb~~~b~~b~~~~~bb~~b~~~~~b~bb~b
b~~b~b~~~~b~~~~~~~b~~~~~b~~b~~b~~~b~bb~b~~~~~~~~~b~~~~b~~b~~bbb~~~~~bb~b~~b~~~~b~~b~~~~~~~b~~~b~b~~~b
bb~~~~~~~b~~b~~~~~~~~~b~~~~~~~~~b~~~~~b~bb~b~~~bbbb~~~~~~b~~~~~~~bb~~~~b~b~~b~~~~bb~~~~~~~~~b~b~b~bb~
~~~~bb~~~bb~~b~b~~~~~b~b~b~~~~bbbb~b~~~~~~~b~b~b~~~~~bb~~b~b~~~~~~~~~~~b~~bb~~bb~~~~~b~~~~~bbb~~~~~~~
bbb~~b~~b~~b~~~~b~~bb~~~~~~~~~~~~~~~~~~~b~~~~~b~~~~~bb~~~~~~~~~~b~b~~~~~bb~~~bb~b~b~~~~bb~~bbb~~~b~b~
~~bbbb~~~~~~~b~~b~~b~~~~~b~b~bbb~~~~b~~~~~b~~~~~~b~~b~b~b~b~~~~~~bb~~~~~~~~~~~~~b~~bb~bb~bb~~~~~~~~b~
~~~~b~~~~b~b~b~~~~~b~~~~~~~b~~~~~~~~~b~~~~bb~~~~~~~~~b~~b~~~~~~~b~b~~~~b~bb~b~~~~~~~~~bb~b~bb~~~b~~~b
~bbb~~b~b~~~~b~~b~b~~~b~~~~~~~~~~~b~~~~~~bbb~~~b~~~bb~~~~~~bb~~~~~~~b~~~~~~bbb~b~~~~b~~~~~~~~bb~b~~b~
~~b~~~~~~~bb~b~~~~~bb~~~~~~b~~b~~~b~b~~bb~~~~~~~~~~bb~~~bb~b~b~~~~~b~~~~~~~b~~b~~~~b~~~~~~~b~~~b~~~~~
~~~~~~~~~~b~~~~~~b~b~b~~b~~~~~b~~~~~~~~b~~~~~~~~~~~~~~~~~~~b~~~b~b~b~~b~~~~~~~~b~~b~~~~~~b~~b~~~bb~bb
~~~~b~~~~~~~~b~~~~~~~bb~~bb~~b~~bb~~~~~~bbb~~bb~bb~~bb~b~b~~~b~~~b~b~~~~~b~~bb~~~~b~~~b~~bbb~~b~bb~~b
~~b~~~~bb~~~~~~b~~~~b~b~b~bb~~~~b~b~~b~bb~~b~~b~~bb~b~~bb~b~~~b~~~~~~~~~bb~~~~~~~b~~~~~bbb~b~~~b~~~~~
~~~~~~~bb~~~~~~~~~b~b~b~b~~bbbb~bb~~~b~~b~~~~~~~~~~b~~~~~bb~~~~~~~bb~b~~~bb~b~b~~bb~~~bbb~~~b~b~~bb~~
~b~~~~b~~~~~~~~~bb~bb~b~b~~~~~bb~~~b~~~b~~~bb~b~b~~~~b~b~~~~~~b~b~~bb~bb~~~~b~b~b~~~~~~~~~~~b~bb~~~~~
~b~~b~~~~b~~~b~~bb~b~~bb~b~~b~~~bb~~~bbb~~~bb~bbb~b~~~b~~~~b~~bb~~bb~b~b~~~~~~~b~~~~bb~b~~~~~b~~~b~~~
~b~~~~~b~~~~~~~~~~~~~~~b~~~~~b~b~b~bb~~b~b~~bb~~~~~bbb~~~b~b~~~~~~~~bbb~b~~~~~b~~~~~~~b~~~~~b~~~b~~~~
~bbb~~~~b~~~~~bb~bb~~b~~b~~~bbb~b~~b~~~b~~b~bbbbb~~~~b~~b~~~~~~bbb~~~~~~~bbb~b~b~~~~~~b~~~~b~~b~b~~bb
~~~~~b~~~~~~b~~~~bb~b~b~b~~~~b~~bb~b~~b~b~~b~~b~~~bb~~~~~~~~~~b~~~~~~b~~~~~b~~b~b~~~bb~~~~~~bb~bb~~~~
~~b~~~~~~bb~~b~~b~~~~bbbb~bb~b~bb~bb~b~~~~~~~~b~~~~bbb~~bb~~~b~~b~~bb~~~b~~b~~~bbb~~~b~b~~~~bb~~~~b~b
~~~~bb~~~bb~~~~b~~~~~~b~b~~bb~b~~~bb~~~~~~~~~~~bb~~~~~b~~~~~~b~bbbb~~~bb~bb~~~bb~~b~b~~b~~~~b~~~~~~bb
b~b~~~b~~~bb~~~~bbbbbbbb~~~~~b~b~~b~bb~~b~~~~b~~b~~~~~~b~bbbb~~bb~~~b~~~~~~~~~b~~~~~~~~~~~b~~~~~bb~~b
~~~b~~~~~~b~~~bb~~~b~~~~~~~~~~b~~~~b~~~~b~~~~b~~bb~~b~~~~~bb~~~~bb~b~~bb~~~~~~~~~~b~~~~~~~bb~bb~bb~~~
~~b~~b~b~~bb~b~~~~~~~~b~~b~b~~~~b~~b~~~bbb~~b~~~~b~~b~b~~bb~~~~~~~~b~~bb~~b~~bb~~~~~~~~~~b~~~~b~~~b~~
b~b~b~b~~b~~~~~~~b~~bbb~~~~bb~~b~b~b~~~~~G~b~~~~~~~b~~~b~bb~~b~bb~b~~~~b~~~bbb~b~~~~~~~bb~~~~~~~b~~b~
~~~b~~~~~~~b~~~~~~~~~~~~~~~~~~~bb~~~~b~~~~~bb~b~b~b~~~~~b~~~~b~~b~~~~~b~~~~~bb~~~~b~~b~b~~b~~~b~b~~b~
~bb~b~~b~b~~~b~~~~b~~bb~~~~~~~b~~b~b~b~~~~~b~b~~bb~~b~~~b~~b~bbbb~~~b~~~~b~b~~~~b~b~~~~~~b~bbb~~~~~b~
~~b~~~~~~~~~bbb~~~~bb~~~~~~b~~~b~~b~bbb~~b~~b~b~~b~~b~b~~~~b~~~b~b~~~~~~~~~~~b~~b~b~~~b~~b~b~~~b~~~~b
~bb~~bb~~bb~b~b~~~~~~~~~~~~b~~~~~~~~~~~b~bb~~bb~b~~~~~bbb~~~~~~b~b~b~~b~b~~b~~~~~~~bb~~~~bb~~bb~~~~b~
~b~~~b~~~~b~~~~~b~~~bb~~~~~~~~~b~bb~~~b~~~~~b~~~~~~~~bbb~bb~~~~b~~~~~~~~b~~~~~~~~~~~~~~~b~~~bb~~~~~~b
b~~b~~bb~~bb~b~~~b~~b~~~b~b~~~~~~~~b~~~b~~b~b~b~~~~~b~~~~b~~b~~~~b~~bb~b~~~~~b~~bbb~~~~bb~~b~~~~b~b~~
b~~~~~b~bb~~~~~b~b~~b~~~b~~~~~~b~~~~~~~b~~~b~~~~~~b~b~~~bbbb~bbb~b~~~b~~~~bb~~~~~~~~b~~~b~~~~~~b~~bbb
b~b~~~~~b~~~~~~~~bb~~b~~b~~~~~~~~~~~~~~b~b~~bb~~~~~~~~~b~~b~~b~~~b~b~~~~b~~bb~bbbb~~~~~~b~~~~~b~b~bb~
~bb~b~~bb~~~b~~b~~~bbb~~b~bb~~~~bb~~~b~~~~bbbbbb~b~~~~~~~b~~~~b~~~b~~~~~~~b~~~b~~~b~b~~~~b~b~bbbb~b~~
~~b~~~~~b~b~~b~bb~~~~~~~b~~~~~b~bbbb~~~b~~~b~b~~~~~~~bbbb~~~~bS~~~b~~~b~b~~b~b~~~b~~b~b~b~~~~~b~~~bb~
b~~b~~~b~b~~~~b~~~~~~b~b~~b~b~~~~b~~~~~~bbbb~b~~~b~b~b~~~~bb~~bb~~bbbb~bb~~~~~~~b~~~~~~b~~bb~~b~b~~~b
~b~~~~~~~~~~~~~~bbbbb~~b~~~~b~bbb~~~~~~~~~bb~~~~bb~~~~bb~b~~~~b~b~b~b~~~~bb~bbbb~~~~~bb~bb~b~~bb~~~~b
~~~~~~bbb~bbb~b~b~~~~~~~bbbb~~~~~~~~~~b~b~~b~~~~~~~~~~~~~~b~b~bb~~b~~~~b~~~~bb~~b~bb~~bbb~~~b~~~~b~~~
~~~~~~~b~~~~b~~~~~~~~b~~bb~~~~~~~~b~~~~~~~~~~~~~~bb~~~~~~~~~~bb~~b~~~b~b~~~~bb~~~b~b~~bb~~~~bb~~~~~~b
~bb~b~~~bb~~~~~~~~~~~~~~~b~~~~bbb~~~~bbb~~b~~b~~~~b~bb~b~~~~~bb~b~bbb~~b~b~~~b~~b~b~bb~~~~~bbb~~~~~~~
~~~~b~~~~bbb~~~b~~~~~bb~bb~~b~~b~~~~~bbb~b~b~~b~~~~b~~b~~~~~b~~~~~~b~b~b~~~~~~~b~~bb~~~~~b~b~bb~~b~~~
b~~~~~~b~b~~~~~b~~~~~~~bbbb~b~~b~~~b~~~~~~~bbb~~~~~~~~~~~~~~~~b~~~b~b~~~~~~~~b~~~~~b~~b~~~~bb~~~~b~~b
bb~~~~~~b~~b~b~b~~~~~~b~~~~~~b~~~~~~~bbb~~~~~b~~b~~~~~bb~~bb~~~bbb~bb~~b~~b~b~~~~~~~b~bb~bb~~~~~~~b~b
~~~~b~b~b~~bb~~~~b~~~~b~b~~~~~~~~~~~~~b~b~~~~b~~~~~~bb~b~~~~~~~~~b~b~~b~~~~bb~~~~~b~~b~~bb~~~~~b~~~bb
~~~~~~~b~~bb~~~b~~b~~~~~~bb~~~~~b~b~b~bbb~bb~~~~~~~~~~~~~~b~bb~~b~~~~b~~~~~~~~b~b~b~~~~b~b~bbbbb~~~b~
b~~~~~~~~~~~~~~~b~~~~b~~~~~~bbb~bbbb~~bb~~~bb~~~~~b~~bb~b~~~~~~~~~~~~b~~~~~~b~bb~~b~~~b~b~~~bbb~b~~~~
b~~~~b~bb~~b~~bbb~~~~~~~~~~~~~~~b~~~~bb~b~~~b~b~~~b~~bbb~~b~~bb~~~bb~~b~~~b~b~~~~~~~~b~~~b~b~~~bb~~~~
~~~~~~bb~~bbbb~~~~~~bb~~bbb~~~~~b~b~bb~~~~~~bb~~~~~~b~b~~b~bb~~~~~b~b~~~~~~~b~b~b~~~b~~b~~b~~~~bb~~~~
b~~~~~bb~~~~bbbb~b~~~~~~bb~~~~~bb~~~~~~bb~b~~~~~b~~~b~b~bb~bb~~~bb~~~b~~b~~~~b~bb~~~~bb~~b~~~b~~~~b~b
~~~bb~~~~~~~~~~~~~bbbbbbb~~~~~~~~~~~~b~bb~~bb~b~~b~~b~~~~b~~~bbb~~~~~b~b~~b~~~b~b~~~b~b~bbbb~~~~~~~~~
bb~~~~~~~~~~b~~~~~b~~b~~~~~b~~~b~~~b~~b~~~b~~~~~bb~b~~bb~~~~~~~~b~~bbb~~~bb~~~~~~~~b~b~~~~~bb~~~b~~~~
~~~bbbb~~b~~~b~~b~~~~~~bbbb~~~~~~b~b~bb~~~~b~b~~b~~~~~b~~~~~~~~~~~~~b~~~~~~~b~b~~~~~~~b~b~~~~b~bb~~~~
~~~~b~b~~~~~~~~b~b~b~b~~~~~b~~~b~~~~~~~b~~~~~~~bb~~~~~~~~bbb~~~~~~~~~~~~~~~bb~~b~bb~~~~~b~~b~~~b~~~b~
~bb~b~~b~b~~~~~b~~~~~~~b~~b~b~bbbbb~~b~~b~b~~b~~~~~~~~~b~b~~~~~~~~~~~~bb~~~b~~b~~~~b~~~~b~~~bbbb~~~~~
~~~~b~~~~~bb~bb~~~~b~b~~~~b~~b~~~b~b~b~~~b~~b~b~~~~~b~~~~~~~~bb~bb~b~~bbb~~b~~b~b~~~~b~~~bb~b~~bb~~~~
~~~~~bb~b~~b~bb~~~bbbb~~b~b~b~~~~bb~~~~~bbb~~~~~~b~b~b~~b~~bbb~b~~b~bb~b~b~b~bb~bbbb~~~~~~~~~b~~~b~b~
bb~bb~b~~~~~~~~b~~~~~~~~~~~~b~~~bbb~~~~b~~~~~~~~~~~~~~~~~~b~~b~~~~~b~~~~b~~b~~~~b~~~~~~~b~~b~b~bb~~~~
b~~~b~~~~~bb~~~~~~~b~~bbbb~~b~~~~~~bb~bb~~~~~bbb~~~b~~~~~b~~~b~b~b~~~~~~~b~b~~~~b~~~~~~~~b~b~~~bbb~~~
b~~b~bbb~bb~~bb~~bb~~~b~~b~bb~bb~~~~b~b~~~b~bb~b~~~~b~~~~~b~~b~~~~~~bb~b~b~~~~bbb~b~~~bbb~~b~b~~bb~~b
~~~b~~~bb~~b~~~b~~~~~~~~~b~bb~~~~~~~~~~b~~~~b~~~b~~~~~~~~~~~~~~b~~b~~b~~~~~b~~~~bb~~~~~~~~~~b~~~~~~~~
~~~~~~bb~~~bb~~~~~b~~~~b~~b~~bb~~~b~b~b~~b~b~~b~~~b~~b~~bbb~~~bbb~~b~bb~~b~~bb~b~~b~bb~~~~~~~~~b~~~~~
bb~b~b~~~bb~b~~~~~~~~~~~b~~b~~~b~~~~bb~~~~b~~~b~~~b~~~b~~b~~~~~~b~~~b~~~~b~~~~~~~b~~b~~~b~~~~~b~~~~~~
~~~~b~~~b~~b~bb~~~~~~~~bb~b~b~~~bb~~b~~~~~~b~bb~~~~~~b~~~~bb~~~bb~~bb~bb~~~b~~b~~~~~~~~b~~b~~~~b~~b~~
~bb~~~~~~~~~~~~~~~b~b~~~~~~b~~~bb~~b~~~~~b~~~~~~~~~~b~~~~~~~~~b~~~~~~bb~~~~~~~~~~b~~~b~bb~~~b~b~~b~~~
~~~~bb~~~~~~b~bb~~~~~~~~b~~~~b~~~~~~~b~b~b~~~~~b~~b~b~~bb~~~~~~~bbbb~~~bbb~~~~~b~~~~b~b~~b~~~~~~~~~~~
b~~b~b~~~~b~~~~bb~b~~b~bbb~bb~~b~~~~b~~~~b~bb~bbbb~~bb~bb~~~~~b~~~~~bb~b~~~~~~~~bb~~b~~~~~~~~~bbbb~~b
b~~~~~~~~bb~b~~bbb~~b~~~~~~~~~~bb~b~~~~~~~~~b~b~~b~~~~~b~~~b~~~~~~~~b~~~~~~~~~~bb~~b~bb~~~~~~~~~~b~~b
~~~~~~~~~~~~b~b~~~~b~bbb~b~~~bbbb~b~bbb~~~~b~~~~~~~bb~bbb~~~~~~~~~bb~~~~b~~b~b~~~~~~~~~~b~~~b~~~~bb~b
~~~~~b~~b~b~b~~~~~~~b~b~~bbbbb~bb~~~~~b~~~~b~~b~~b~~b~b~~b~~b~~~~~~~~~~bbb~bb~~~~~~b~~~~~~~~~~~b~b~b~
~~~~b~~~bb~~~~~~~~b~~~bb~b~~b~b~b~bb~~~b~~b~~~~b~~~~~~bb~b~~~~~~~~~~~~~~~~bbbb~~bb~bbb~bb~~~~b~~~~~b~
~b~~b~~bb~~~b~~~~b~~~~bb~~~b~b~~~~~b~~b~~bb~~b~~~~~~~~~~b~~b~~~~b~b~~~bb~~b~~b~bb~~~bb~~~~~bb~b~bb~~~
~b~b~b~~~~b~~~~b~~b~~~~~b~~~~bb~~bb~~b~~~~~b~~~b~~~b~~b~b~b~~b~~~~~~~~~~~~b~~b~~~b~bbb~~~~~~~~~b~~b~~
~bbbb~bbbb~~~b~b~~bb~~~bb~~~bbb~bb~~~bb~~b~~~~~bb~~~bbb~~~b~~bbbb~b~~bb~b~bbb~~~~~~~~~bb~b~b~b~~~~b~~
b~~b~~bb~~b~~~~b~~b~~~~~~bb~~b~b~bb~b~~b~b~~~~~b~~b~~~b~~~bb~~~b~~~~~~~~~~~b~~~b~~~bbb~~~b~~~~~b~~bb~
b~~~~~~~~~~~~~bb~~~~~~b~~~~~b~~~~b~~~~~~~~~~~b~~b~b~~~~~~~~b~~~b~~~~~~~~~b~b~~b~~~~~b~b~~b~~bb~bb~~~~
b~~~~~~b~~b~b~~~~~b~~~~~~~~bb~bbb~~bb~~~~bb~~~~bb~~b~~~~~b~~b~~b~bbb~b~~~~~~~~bbb~~~b~~~~bbb~b~~~~~~~
~~~b~bbb~~~b~b~~~b~~b~~~bb~b~~b~bbb~~~~~b~~~~b~~~b~~bb~~bbb~bb~~bb~~~~b~~~bb~b~~~~~~b~~b~~~~b~b~~b~~~
bb~~~~b~~~~bb~~b~~~~~b~~~~~~~b~~b~~~~~~b~b~~~~~~~~b~b~b~~~~~b~bb~b~~~~b~~~b~~b~~~~~~~~b~bb~b~bb~~~~b~
b~b~~~bb~~~~~~b~b~~~~~~~b~~~~~b~~~b~b~~~~~~b~~~~~b~b~~~b~~b~~~b~b~b~b~b~~~b~b~b~~b~~~~~b~~bbb~~bb~b~b
~~~~~b~~~~~b~~~~b~~~~b~~bb~~~~~b~~~~~b~~b~~~b~~~~bb~~~~b~~b~~~~~~~~~~~~~~~~bb~~b~~~b~b~~~~~~~b~~~b~~~
~~~~b~~~~~~~~b~~~~~~~~~~~~~~~~~~~b~~b~b~~~bb~~~~bbb~b~~~~~~~~~b~~~~bb~b~b~~bbb~~b~~~b~~b~~b~~~~~b~b~b
~~~~~~bb~b~~~~~bbb~~~b~~bbb~~bbbb~~~~~~~~~~~~~~~b~b~~~~~~~~~~b~b~b~~~bb~~~~~b~~~b~~bb~~~~~b~~b~~~b~~~
b~~~~~~~bb~b~~~~~b~b~bbb~~b~~b~~b~~~b~bb~~~~~b~~b~~~~~~b~~~b~bb~~~b~~~b~~bb~b~~~bb~~~b~~b~b~~b~b~b~~~
~~~~~~~~b~~~~bb~~~~~~~~b~bb~b~~~~~~~~~~~~b~b~~b~bb~~~~~b~bb~~b~~~~~~~~~~~~b~~~~~~~~~b~~b~~~~~~b~~~~~~
~~~~bb~~b~b~~~~b~b~~b~~~~~~~~b~~~~~b~~~~~~b~~~~~~~~b~bb~~~b~~~bb~~~~~~~~b~~bb~~~b~b~~~~~~~~~~~~~b~~~~
