~~~~~~~bb~bb~bb~~~bb~~b~b~~b~~~~~~~~b~b~~~~b~~~b~~bb~bb~~~b~b~~bbb~~~b~bb~bb~~~~~~~~b~~~~~~b~~~~~bbb~
~bb~~b~~~b~~b~b~~~~~~b~~~~~~b~~bb~~~~b~~~~b~~~~~b~~~b~b~~bb~~~~~~~~~~~b~b~b~bbbb~~~b~~~~b~~~~~~~~b~~~
~~bb~~b~~~bbbb~bb~bb~~~b~~~~~~b~~~b~~~~~~bb~~b~~~b~bbbb~bbbb~~~~b~~~~bb~~bbb~~~b~~b~b~b~~~~~b~~~~~~~~
~~b~~~~~bbb~~b~~~~~~~~~bb~~b~~~~~~bb~b~b~~~~bbb~~~~~bb~~~~~b~bbbb~bbb~~~~b~~~~~~bb~~~~b~~bb~bbb~~~bb~
b~b~~~~~~~~~~~~~b~bb~~~~~~~~~~b~~~~bb~~bb~~bbb~b~~bb~~~~~b~b~~~~~~b~b~~~~b~~~~~~~b~b~~~~~~~~~~bb~~b~~
~~~b~~~~~~~~~~~~~~b~~bb~~~bb~~b~~bb~~~~b~b~~~bbb~~~bb~~bbb~~~~b~bb~~~~bb~~~~b~~~~~~~~b~~~~~~~~b~~~~~~
~~b~~~b~~b~~~~~~b~~bbb~~b~~bb~b~b~~b~~b~~~~b~~~~~~b~~~~b~b~~~~~bbb~~bb~~b~~~bb~~~~b~b~~~~~~b~~~b~~b~~
~~~~~~~b~~~b~~~bb~b~~~b~~b~~b~~~~~~~~~~bbb~b~bbb~~~~~~~~~~~~~~bb~bb~~~b~~~~~~b~~~bb~~~~b~~~~~~~b~bb~b
~~~bb~b~~b~~~~b~~~~b~~b~~~~~~~b~b~~~~b~~~b~~b~~~~b~~~b~b~~~~bb~~~bb~b~b~~~b~~~~bb~b~b~~~~b~b~~~~bb~~b
b~~~~~~bb~~~~~b~~~~~~~~b~b~~~~~~b~~~~~~~~b~b~~b~~~~b~b~~~bb~~b~~~~~~bb~bb~b~~b~~~~b~bb~~~~bbb~~~~b~b~
b~~~~~~~~~b~~~~~bbb~b~~~b~b~~~~~~~b~~~~~~b~~bb~~~~~~~~~~b~~~~~bb~~~~~~~b~~b~bb~b~~~b~~bb~~~~~~b~~b~~b
~~b~~~~b~~bb~~b~bb~~b~~~~~~~~~~b~~b~~~~~b~~~b~b~~b~~~~b~bb~~~~~~~~~~~~b~~~~~~~bb~~~~b~~~bb~b~~~~~~~bb
~~b~~~b~bb~bbbb~b~~bb~b~b~~bb~b~~~~b~~~~~~~b~b~bb~~~~~~bbb~~~bb~~~~bb~b~~bbb~~~b~~~~b~~b~~bbb~~b~b~~~
~bbb~~~bb~b~b~b~~bb~b~~b~~~~~~~~~~~~b~~~~bbb~~~~~~b~~~~~~~bb~~~~bbb~b~~bb~bb~~~~b~b~b~bbb~~~~~~bb~b~~
~~~~~bbb~b~~~~bb~b~~b~~~~~~bb~~~~~b~~b~b~~~~~~~~~~~~~~bb~~b~~~b~bb~~~~~~~~~~b~~b~~~~b~~b~~~~b~b~b~b~~
~~~~~~~~~~~~b~~~~~b~~b~~~~bb~~~bb~~b~bb~b~~bb~~~~~~b~~~~b~~~b~~b~~b~~b~~b~~~bb~bbb~b~~~b~~~~~~~~b~~~~
~~~~~~~~~~~~~~b~~~~~~~~~~~~b~~~~~~bb~~bbb~b~bb~~~~~~~~~~~b~~~~bb~~~~~~b~~~~~~~~b~~~b~b~~~bb~~~~b~~~~~
~~~~b~bb~~~bbb~~b~~b~~~~~~b~~~~~~bbb~~~b~bb~~~~~~~b~~~b~bb~~~~~b~b~~~~~~~~~~~b~~b~~~~~b~~bb~~~~~b~~~b
b~~~~~b~~~~~b~bbb~b~b~b~~~~~~~~~~~~~~~~b~~~b~~b~~~~~~~b~b~~b~~b~bb~~~~~~~~~~bb~b~~~~b~~~~~~b~bb~~~~~~
~~b~~b~~~~~~~bb~b~~~~~~b~~~~~~b~bb~~b~~bbbb~~~~~bbb~~~~~~~b~~b~b~~~~~~b~~~bb~~~bbbb~b~~b~~b~bb~~~~~b~
~~~~~~~~~~b~~~b~~~bbb~~~~~~b~~bb~~~~b~~b~b~bb~~~~b~~~~~bb~~b~~b~b~~b~~~~~~b~b~~~~b~~b~~~~~~~b~b~b~~~~
b~~b~b~bb~~b~~b~~~~bb~b~~~~~~~~~b~b~~~~b~~bb~~~~b~~~~~~~~~b~~~~~~~bbb~~bb~b~b~b~~b~~~b~~bb~~bb~~~b~~~
~b~~~~~~~~~~~~~~b~~b~bb~~~~~b~~~b~bb~~b~b~~b~~~bb~b~b~b~~~b~~b~bb~~~~~~~~~~b~~~~b~~~b~~~~~bb~~~bb~~~~
~b~~~bbb~~~~~~b~~b~~~~~~~~~~~~b~b~~b~~~~~~~~~~~~~b~~~~~b~bbb~~~~~~bb~~~b~b~~bb~b~~b~~~b~b~~b~~~~~b~~~
~~~~~~~b~b~~~~~~~~b~~~~~~~~~~~~~~~~~~bb~~~b~~~~b~~~~~~~~~b~bb~~b~~b~~~~~bb~~b~~~bbb~~~bbb~~bb~~b~~~~b
~b~b~~~~~b~~~b~~~b~~bb~bb~~b~~~~bb~~~~~b~~b~~~~~~b~~~~b~b~~~~bb~b~b~bb~~~~b~~~b~~~b~~~~~~~~~~~~~~~~~b
b~~~~b~bb~~bb~b~b~~~b~~~~~bbb~~bb~~~~~~bbb~~~~bbbb~~bb~~~~~~~~~~~bbbb~~~~~bbbb~~~~~~~~~~~~~~~~~~~~~b~
~~~~~b~~b~~b~~~~b~~~bb~~~~b~~~~~~~~~~~~~b~~b~~b~~~b~~~~~~bbbb~b~~~~~~~~b~~bbb~~~~~~~~~~~~~~bbb~~~~~~b
b~b~~~~bb~~~b~~~~b~~~~b~bb~~~bb~~~~~~~~~b~~~~b~~~~~~b~~~b~~~b~bb~~~~bbb~bb~~~bb~~~~~bb~~b~~~b~~~b~~~~
~~~~~b~bb~~~~~b~~~~~~~b~~~~~~~~b~~bb~bbb~~~~~~~~b~~~~~~b~~~~~b~~~~b~~~b~bb~b~~~b~~~~~~~~~~b~~~b~~~~~~
~b~~b~~~b~~b~~~~b~~~b~bb~~b~b~~~~b~~bb~~~b~~~bb~b~b~b~~~b~b~~b~b~b~~~bb~~~~~~b~~~~~b~~~bbb~~~~~b~~~~b
b~~~~~b~~~~~bbb~~~bb~~~~b~b~~~~~~~~bb~~~~~~~~bb~b~~~~b~~~bb~~~~~bb~~~~~b~~~~~~~~~~~~bb~~~~~b~~~~~b~~~
~~~~~~~~bb~~~~~~~~~~bb~~bbb~~~~bbbb~~~~~~~bb~bb~~b~bb~b~bb~b~~b~b~bbb~~~~~~~bb~~~~~b~~~b~~~~b~~~b~b~~
~~~~~~~~~~~b~~~~~~~~~b~b~b~~~~~~b~~b~b~~bbb~bb~b~bb~~b~~~~~~~~bb~~~~~b~~~~~~bb~b~b~~~~~~~~b~~~~bb~~bb
~b~~~~~b~~~~~b~~~b~b~~~~bbbb~b~~~~~~bb~~~b~~~bbb~~~~~~~~~~bbb~~bb~b~b~~b~~~b~~~~b~~~~~~b~~~b~~~~b~b~~
~~~b~bbb~~b~~~~b~~b~~~~~~~b~~~~~~~~~b~~~~~~~b~~b~bb~~~~~~~b~b~~b~~b~~~b~bb~~b~~~b~bb~~b~~~bbb~b~~b~~b
~~~b~~~~b~bbb~b~~~b~~b~~~b~~b~~b~~~~~~~~~~~~~~~~~~b~~b~b~~~~~b~~b~b~~~~~~b~~~~~~bbb~~~~b~~~b~~~bb~bb~
b~~~bb~~b~b~~~~~~~bbb~b~bb~~b~bb~~~~b~~~~~~b~~~~bb~~~~~b~~b~~~~b~b~b~~b~b~~~~b~~~~~~~~~bb~~~b~b~~~~~~
~b~~~~bbbb~~b~~b~~~~~~~~~~~~~~b~~~bb~bb~b~~~~~~~~b~b~~~~b~~b~~~b~~~~~~~b~bb~b~~~b~b~~b~~b~~~~~~b~~~b~
b~~~~~~b~~~~~~~b~~~~~~b~~~bb~~b~~~bb~~b~~b~~b~b~~~~b~~b~~~~bb~bb~b~~~~~~~~~~~~~~~b~~bb~~bbbb~~~~~~b~~
~b~~~~~b~~~b~bbb~~bb~~b~~~bb~~~~~~~b~~~~~~~b~b~b~~b~~~~~~~~~~b~b~~b~~~b~b~~~b~~b~b~b~b~~~~~~bb~~~bb~~
~b~~~~~~~~~~b~~~~~~~b~b~~~~b~~~~bb~b~~~~b~~bb~b~~~~~~~~~~b~b~b~b~~~~~~~~bb~~b~~~b~bb~~b~bbb~b~~~~b~bb
~~b~~~~b~~~~bb~b~b~~~b~~~~b~~~~~bb~~b~~b~b~~~b~~~b~~~~~b~~b~~~~~~b~~~~~~~~~~b~~~~~~~b~b~~~~~~~~b~b~~~
~~~b~~bb~~~b~~bbb~~b~~~~~~b~b~~~~~~bb~~~b~b~~b~b~~~~~b~~~~~~~b~~b~~~~~~~bb~~~~b~b~b~~~~~bbbb~~~~b~bb~
~~~~~~~~~~~~~b~~bb~~~b~~bbb~~bb~~~~~~~~~~~~~~~b~~bb~~~bb~~~b~b~~~~~b~~~~~~~b~~~~~~b~b~b~b~~b~bb~b~~~~
~bbb~~~~b~b~~bb~~~b~~b~~~~bb~~~~~~~b~~b~~~~bbb~b~b~~b~b~b~b~~b~b~b~~~bb~~~~b~~bb~~~~~~~~~~bb~~b~~bb~~
~~~b~bb~~b~~b~bbbb~bb~~~~b~~b~~~~~~bb~~~~~~~~~~b~~~bbb~~~~~~~bb~~bb~~~~~bb~bb~~~b~~~~~b~b~~~~~b~~~~~~
~~b~~b~~~~~~b~b~~b~~b~~~b~~~~bbb~~~~~~~bb~~b~~~~~~~~bb~b~b~b~~~bb~bb~~~~b~~b~b~~b~~~~~~b~bbb~bbbb~b~~
~b~~~~~~b~~b~bb~~b~~~~~~~~b~b~~~b~~~b~b~~~~b~~~~bb~~~~~~~bb~~~~~b~~b~~~b~~~b~~~~b~~~~~~~~~~~~~~b~~~b~
~~~~~b~~~~~b~b~bb~~~b~~~b~~~~b~~~b~~~~~~~~bb~~~~~bb~~~~bbbbbb~b~~~~~~~~b~~b~bb~~~~~~~~~~bb~b~~~~~~~~b
~~~~~~~~~~~~~b~b~~b~~~~b~~~b~~~~~~~~~b~~b~b~bbb~~b~~~b~~~~~~~~~~~bb~~b~~~~~~~bb~~~~~~~~b~~~b~~~~bb~~~
b~~~b~~b~~~~~~b~b~b~bbbb~bbb~~~~b~bb~b~~~~bbb~~~~~~~~~~b~~~~~~~~~~b~b~b~b~b~~b~~b~~~~~~~~~b~~bb~~~bb~
~~~~~b~b~~b~~~~b~~~~~bb~b~~~~~~bbb~bb~~bbb~bb~b~~b~bbb~b~~bb~b~~~~~~~~~bbb~~b~~bb~~~~b~~~b~~~~b~b~b~~
~bb~b~~b~~~~~b~b~~bb~~~b~~~~~~~~~~~~~b~~bbb~b~~b~~~~~~b~~~~b~b~~~~~~~bb~~~~b~bb~b~bb~~b~~~~bb~~b~~~~~
~b~~~~~~~~bb~b~~~~~~bb~~~~~~b~~b~b~~~~b~b~~~b~b~~~bb~~~~b~b~~b~b~~~~~~~~bbb~~~~~b~~~~b~b~~bb~~~~~b~~~
bb~~bbb~~~~~b~b~b~~~~~bb~~b~~b~bb~~~~bb~b~~b~~~~~b~b~~~~~~~~~~~b~~~b~bb~b~~~~b~~~~~b~bbbb~~b~b~b~~~~b
~~~~~~~bb~~~b~b~~~~~~b~~~~~~~~~~~~~~~~b~~~~~b~~b~~~~~b~~~~~b~~~~~~~~~~~~~~~b~~~b~~~~b~~~~~~~b~~~~~b~b
~~~~~~~b~~~~~~~b~~~~b~~~~~~~~~~~b~~~~b~~~~~bb~~bb~~~b~~~~~b~b~~~~bb~b~b~~~~~~~~b~~b~~~~bb~~~b~~~~~~~~
~b~~b~~b~~~~b~~~~~~bb~~~b~~b~~~~~~b~~~~~~~b~~~b~~~~~b~~~b~~~b~~~~b~~~bb~~~~~b~~~~~~~~~~~b~b~~b~~~~~~~
bb~bb~~~b~b~~b~bb~~~~~~~~~b~~~b~~~~~b~~~b~~b~~~~~~~~~~~~bbbb~bb~~~b~~~b~~~b~bbbb~b~bbb~b~bb~~~~bb~~~b
~~~~~~b~~~~~~~~~~~~~~b~~~~~~~~bb~~~~bb~~b~~bbb~b~b~~~bbb~~~~bb~~~bbbb~bbb~~~b~b~b~b~bbb~~~b~~~b~~~~b~
bb~~~~bbb~bbb~~~~b~~~bb~~~b~b~~~~~~~~~b~b~~~bb~~b~~b~~b~~~bb~b~~~~b~~b~~b~b~~~~b~b~b~~~~~~bb~~b~~~~b~
~~~~bbbb~~~~b~~~bb~~~~b~~~~~bb~~~b~~~~~bbbb~~~~~~~~b~~~~~b~b~b~~~~~b~~b~~~~~b~~~~~bb~~b~~~~~~~b~~b~b~
b~~b~~bbb~~~bbb~b~bbb~b~~~b~~~~~~bbbb~~~~bbb~b~~b~b~~~~b~b~b~~~~b~~~~~b~~~bbb~b~~b~~~~~~~~~~~~~~b~~~~
~~~b~~b~~b~~b~~~bbbb~bb~b~~~b~~~~~~~~~~Gb~~~~~~~~~~~bb~~~~~~~~bbb~bbb~~b~~~~b~~bb~~b~~~~b~~b~b~~~~~~~
~~~~~b~bbb~~~~~~~b~~~~b~~~~b~bbb~b~~~b~b~b~~~~~~~~~~~~~~~~~~~b~bb~b~~~~~b~~~~bb~~~~~~b~~b~~bbbb~~~bb~
bb~~~~~~~~~b~~~~~~b~~b~~b~~~~~b~~~~~~b~b~b~~~~~~b~~~~b~~b~~b~b~~~~~~~~~b~b~b~~~~b~~bb~bb~~b~b~b~~~bb~
~~b~~~~b~~~~~~b~~bbbb~~b~~~~~~~~~~b~~~bb~~b~~~~~~~~~~bb~~~~~~~~b~~bb~~~~~~~~~~~~~~bb~b~~~~~b~b~~~~~~~
~~~~~~~b~~~~~~~~~bbb~~~b~bb~~bbb~b~~~~~~~~~~~~~b~~~~~~~~~~~b~bbbbb~~~b~~~~~~~~~b~b~bb~~~b~~~~b~~~bb~b
~b~~~~~~~b~~~~~~b~~~b~~b~~~~~~~b~~b~~~b~~b~b~b~~~~b~~~~~b~bb~~~~b~~~~~~~~~bb~~~~~~~~~~b~~~~~~~~bb~bbb
bbbb~~bb~~~~b~~~b~~~~~b~~b~~bb~~b~~~~b~~~~~b~~~~~~~~~b~~~~b~b~~~~~~~~~~~~~~~~~~~~~~~bb~b~b~~~~~~~~~~~
~bb~~~~~~~~b~bb~bbbb~~~~bbbbb~~~b~b~~~~~bb~~~~~~~~bb~b~~~~b~~b~bb~~bb~~b~~~~~~~~b~b~~b~~~~~~b~~~~bbbb
~~~~~~~b~~~~~b~~~~~~~b~~~~~b~~~b~b~~b~~~~~~~b~b~~b~~~bb~bb~~b~b~~~~b~~~~b~~b~~bbb~b~b~b~b~~~~~~~b~~b~
~~~b~~~~~~~~b~b~bb~~~~~~~~~b~~b~b~~~~b~~~~~b~b~~~~~~~b~~~b~~~~~~~~b~bb~~~~~b~~bbb~~~~bb~~~bbb~~~b~b~~
bb~~~~~b~b~bb~~~~bb~~b~~~b~b~~b~~b~~bbb~~~~~~~bb~bbb~~~b~~~~~~~~~bb~~b~~~~~bb~b~~~~~~b~bb~~~~bb~b~bbb
~b~~~~b~~b~~bbbb~b~~b~~~~~b~b~~~bb~~~~~~~b~~~~~bb~~bbbbb~~~~~~b~~~b~b~b~b~~~~~~~~bb~b~~~~~~~~bb~~~~b~
~~~b~~~b~~~bb~~~~~~~~b~~b~~bbb~~~~~bb~b~b~b~~~~~~~b~~~b~~~~~~~b~~~~~~bb~b~bbbb~bb~~b~~~~~b~~b~~b~~~~~
~b~bb~~bb~~~~~b~~~~~~~~~~b~~bb~~~~~~bb~~b~~b~~~~bbb~~~~~b~~~b~b~~~~~~~~~~~~b~~~~~b~~~~~bb~~~~b~~b~~~~
~~~~b~~~~~b~b~~~~b~~~~~b~bb~~~~~b~~~b~~b~bb~~~bb~~b~b~~~~~~~b~~~~b~~b~b~~~~~b~~b~~~~~~~b~~b~~~~~~~~~~
b~~~bbb~b~bb~b~~~~~~bb~b~~bb~~~~~~b~~~~~b~~~~~~~~~b~~~b~~~~b~~~~~~~bb~b~b~~~~~b~~b~~~b~~~~~~b~~~~~~~b
~~~b~b~~~b~~~~~~~b~~~~~~~b~b~~~bb~~~~b~~b~bbbbb~~b~b~~b~~b~~~~~b~~~bbbb~~~b~~b~b~~b~~~~~~b~~~~~b~~~~~
~~b~b~~~bb~~b~~b~~~~~~~~~~~~~~~~~~~~b~b~~bb~~~~~~~~b~b~~~~b~~~~~b~~~bb~~~~~~b~~bbb~~~bb~~~~bb~~~~~bb~
~~~~b~b~~~~~~~~~~~b~b~~b~~~~~bb~b~~~b~bb~~bbb~b~bb~~~bb~~b~~b~b~~~~~bb~bb~bb~~~~~~~~b~~b~~b~b~bb~bb~b
b~~b~~~~~~bb~~b~~b~~~~~~b~~~~~bb~~~~~~~~~b~~~~~~~bb~~bbbb~b~~~~b~b~~~~b~b~~~~~~~~~~bb~~~~~~~~~~~~~~~b
~~bb~~b~~~b~~bb~bbb~~~~~~~b~~b~b~~~~~~~~~~~bb~bbbb~~b~b~~~b~~~~~b~~b~~~~~bb~~~~bb~~~~~~~b~~~~b~~bb~~~
~~~~b~~b~bb~~~~~~~bb~b~b~bb~~~~b~b~~~bbb~~~~~~~~~~~bb~b~~b~~~bb~~~~~b~~~~~~~b~~b~bb~~~bb~bb~~~~~~b~b~
bbbbb~bb~b~b~~~~~~~b~~~~~~~~~b~~~~b~~b~~~b~bb~~~~~~b~~bb~~~b~~~~~~~~b~~~~~~~~~~~b~~b~~~bb~b~~b~~~b~b~
~~bb~~b~b~bb~~~~~b~~bbb~~~~bb~~~~~b~b~b~b~~~b~~b~bb~b~b~~~b~b~~~~bb~b~~~~~~~~b~~~~b~~b~b~b~~~b~~b~~~b
~~~b~~~~~b~~~~~~bbb~b~~b~bb~~~~~~~~~~~~~b~~~~~~~bb~~b~~~~~~~~~~~~~~~~~b~b~bbb~~~~~~~b~~~~b~~b~~~bb~b~
~~b~~~b~b~bbbb~~~~b~b~~~~b~b~bb~b~~~~~b~b~b~bb~~~~~b~b~b~~b~~~~b~b~~~b~~~~~~~~b~~b~b~~~~b~~b~bb~~~b~~
~~b~~~b~~~~b~bbb~b~b~b~~~~~~bb~~~~~~~bb~~~~~~~~b~~b~b~b~bbb~~~~~~b~b~~~~~~b~~~~~~~bb~~~~~b~~~~~~bb~~~
bbbbb~~~~~~~~~~~~~~b~~b~bb~b~~~b~~~b~~~b~~~~~b~~~~bb~~~~~~~~b~~~~~~~b~b~~~~~~~~~b~bb~~~~~~~~~b~~~~bb~
~b~b~b~~~~~b~~~~~~b~b~~~b~~~~b~~~~bb~bb~~~~~~~b~~~b~~~~~~~~b~~~~~~b~bb~~~bb~~~b~b~~~b~~~~~~b~~b~~~~~~
b~~~~~b~~~~~~bb~bb~bb~bbbb~~b~b~~~~~~~~~~b~~~~~bb~bb~~~bb~~~b~bb~~~~~b~~b~bb~~~b~~~bb~~b~bb~~~~~~~b~~
~~~~~~~b~~~bb~~~b~bb~b~~~b~~~b~~~~~~bbb~~bbbb~~~~bbb~~b~b~bb~~bb~~~~~bb~~~~bb~~bb~~~~b~~~~~~~~~~~~~~~
~~~~~~~~~~bbb~~b~~~~bbbb~~~b~bb~~~~~~~~~b~~~b~b~~b~b~bb~~~~~~b~~~b~b~b~b~~~~b~~b~b~~~b~~~bb~b~~~~~bbb
bb~~~~b~~b~~b~~b~~~~~b~~b~~~~~~~~~~~~~~~~~~~~bb~~~~~bb~~~b~~~~~~~~~~~~~~b~b~~~~~~~~b~~b~~bbb~~~~~~bbb
~bb~~~b~~~~~~~b~~~bb~bb~~~~~~b~~~~~~b~~b~~~b~b~~~b~~b~b~~~~~~~b~~b~~~~~~~b~~~~~b~bb~~~~b~~~~~~~~bb~~~
~~bb~b~b~~~~~~~b~~~~b~b~~~b~b~~~b~~~b~bb~b~~~~~b~~~b~~b~b~~~~~~~b~~~b~~~~~~b~~~b~~~~~~bbb~bb~~~~~~~~~
b~~bb~~~~~b~b~~bb~~b~~~b~b~~~b~~~~~~bb~~bb~~b~bb~~~b~bbb~~b~~~~~~~~~~~~~b~b~~~b~~~~b~~~bb~b~~~b~~~~~b
~~~~~b~~~~~~~~~~~~~~~Sbb~~~~~~~~b~~~~~~~~~~~b~~~~~~~b~~~~~~b~~~~~b~bb~~~~~~~~~~~~~~bbb~~~~~~~~b~b~~b~
