~~b~~bb~~~~~~~~b~b~~b~~~b~b~bbb~b~b~~~~~~b~b~~b~~b~b~b~bbb~b~~~bb~~b~~~b~b~~~~~b~b~~~~~~b~b~~~~bb~b~~
~~b~~~~~b~~~~b~~b~~b~~~~~b~~b~~~~~b~bb~b~~~bb~~~~~b~~~~~bbb~~bb~b~~~~~~~~~~b~~~b~b~~~~~b~~b~~~bbb~~~~
~~~bbb~b~bb~~b~b~~~bb~~b~~~~~~bbb~~~~~~~~~~b~~b~b~~b~~~~~~bb~~~~b~~~~~~~~bb~b~~~b~~b~~bb~b~bb~~~~~b~~
~~~~~~~~~~b~~~~~~b~~~bb~~~~~b~~~~~~~~~b~~b~~~~~b~~~~~bbb~~~~~~~~~b~bb~~~~~~~~~b~~~~~~~~~b~~~~~b~~b~bb
~b~~~~~~~~bbbb~~b~~b~~~~~b~~~~b~b~~b~b~b~b~~~b~~~b~~~~~~b~~~~~~~~~~b~~~~~~~b~~b~b~b~b~b~~~b~b~~b~bbb~
~~~~bbb~~~~~~~~~bb~~b~~~~b~~~~~bbb~~~~~b~~~~~~~bb~~~~bb~b~~bbbb~bbbb~~~~b~~~S~b~b~~~~~b~b~~~~~~~~b~~b
~~~~~b~~b~~bb~~~bb~~~~~~~~~~~~~~~~bb~~~b~b~~~b~bb~~~b~~b~~~~b~~~~~~~~~~~~~bb~b~b~b~~~~b~b~~~~~~b~~b~~
b~~~~~b~b~~~b~~~~bbb~b~b~bbb~~bbb~~~~~b~b~b~b~~~~bb~~~~~~~~~~b~~~bbbb~~~b~~~bb~b~b~b~~bb~~b~~b~~~~~~~
~~~b~~~b~~b~~~~b~~b~~~~~~b~~~~~~~bb~~~~b~b~~~~~~~~~~b~b~~~~b~b~~~b~~~~~~~~b~~b~~~~~b~bb~~b~~~b~~~bb~~
~~~b~~~~b~~~~~~~~~~b~~~~~~~~~~~b~b~~~~~~~~bb~~~~bb~~~~~~bbbbbbbbb~b~b~~bb~b~b~~~~~~~b~b~~b~~~~b~~~~~b
~bb~~b~~bb~~~~~~~~~~~~~b~~~~b~b~b~~b~~~~~~~b~~~~~~~~~~~b~~b~b~bb~b~~bb~~~~~~~~b~b~~~b~b~~~bbb~b~bb~~b
~bb~bb~bb~~~~~~~b~~~b~~~~b~b~~~~~~~bb~~~~~~~~~~~~bb~bb~~~~~~~~~~bb~~~~~~~~~~~~~~bb~~~~~~~~~b~~~~~~~~~
bbb~~bbb~bb~~~~b~b~~b~~~~bbb~~b~~~~~b~~b~~~b~bb~~~b~~~~~~b~~b~bb~~~~~~~~~bb~~~~~~~~~~~b~~~b~~b~b~~~~~
~~~bb~~~b~~~~~~~~~b~~~~~bb~~~~~~~~b~~b~~~bb~~~~b~~~~~~b~~~~~~~~~~~b~b~b~~~bb~b~~~~~~~~~bb~b~~b~~~bb~~
b~b~b~~~~~~b~~~b~~~~b~~~~~~~~~~~b~~b~b~bb~~~~b~~b~b~~b~~b~~~~~b~~~~~~~~~~~~~~~bb~~~~~~~~~~~bbbb~~b~bb
~~~b~~~~~~b~b~~~~~~~~b~~~~~~~~bb~~b~~~~~~~b~bbb~~~b~~~~~~~~~~~~~b~b~b~~b~~~~~b~~~~~~~~~~~~~~b~~~~b~bb
b~~~~b~~b~bb~~~~~~~~bb~~~~~~~b~~~~b~~~b~~b~~~~~~~~b~~~~~b~bb~~~b~~~~~~~b~~~~~~~~~~b~b~~~~~~~~b~b~~b~~
b~~bb~b~~~~~~~~b~b~~~~~~~bb~bb~~~~~~bb~~~b~~~b~b~~b~~~~~~bb~~~b~~~~~~~~~~~~~~~~~~~~~~b~bbb~b~~~~~~~~b
~bb~~~b~~~~~b~b~~~~bbb~~b~b~~~b~~~~b~~bbbb~b~~~b~bb~~~bb~~b~~~~~b~~~b~b~~b~~b~~~~~~~~~~~bb~~~~~bb~~b~
b~~~~~b~~~~~~~~~~~~~~~~~bb~~b~b~~~~~~~~b~~~~b~bb~b~~~~~bb~b~~~~~~~~~b~b~~b~~~~~~~~~~~b~~bb~bb~~~~~~~~
~~b~~~~~~b~~~~~~~b~~~~~~~b~~b~b~b~b~b~~bbb~~~~~~~b~~~~~~~b~~~~~~~~~~bbb~b~b~~~bb~~~~~~~b~~b~b~~b~~~~~
~b~~b~~~~b~bbb~~~~b~b~~~~b~~~~~~~~b~~b~~~~~~~b~~~~b~~~~~~~~b~b~bb~~~b~bbb~~~~~~~~~~~bbbb~~~~~b~~~~~~~
~~~~~~~~~~~~~b~~b~~b~b~~~~~~~b~~b~~~~~~~~~~~~b~~~~b~~~~~~~~~b~~b~~bb~~b~~~b~b~b~bb~~~b~bb~~~~~b~~~b~~
~b~b~~~~~b~b~~~~~~~~~bb~~~~b~~b~b~~~bbb~~~bb~bb~b~b~~~~~b~b~b~~bb~~~~~b~~~~~~~~b~~~~~~b~b~b~~~~~~b~b~
b~~~~~~~~~~~~~~~b~~~~~~~~~~~~bbbbbb~~~~~b~bb~~b~~b~~~~bb~~~~~~b~~~b~~~b~b~bb~b~~~~b~~bb~b~~~bb~~b~~b~
~~bbb~~bb~b~~~~~~b~~~b~b~~~b~~~~~~~~~~bbb~b~~~bbbbb~~~~~b~bbb~~~~b~~~b~~bb~bb~~~~~~~bb~bb~~b~b~b~b~bb
~~~~bb~~~b~~~~~b~bb~~bbbb~~~~~~~~~b~~~~~~b~~~~b~~~~b~bb~~~~bb~~b~~~b~bb~~~b~~~b~~b~~~b~b~b~bb~bbbb~~~
~b~~~bb~~~bb~~~~~~b~b~~~~~~~~~b~~~~~~~~~~~b~b~~~~bb~bbbb~~~~~b~~~~~b~~~~~b~bb~~~~bb~b~b~~~b~~~bb~~~bb
~~~~b~b~~~~~b~~~~bb~~b~b~~b~~~b~~~~~~~~~~~b~~~~~~bb~b~~~~~b~~b~~~~~~~~~~bb~b~bb~~~~~~~~b~~~~~b~bb~b~~
bb~bb~~~bb~bb~b~~b~bb~~~b~~~~~~b~~~~~~~b~~b~~~~b~b~~~~~~~b~~~b~b~~~b~~bb~b~b~~bb~~~~~b~~~~bb~bb~~~b~~
~~bb~~~~bb~~~~bbb~~b~~~~~~~~b~~~b~~b~~~b~~~b~~~~b~~b~bb~~b~~~~~~b~b~~b~~~b~bb~~b~~~b~~b~b~b~b~~~b~b~~
~~~b~~~~~~~b~~~~~~~~~~b~~~~b~b~b~~~~~~~~b~~~bb~~b~~~~~b~~~~~b~~~~~~~~~~~b~bb~~~~~~~b~~~~bbb~~~b~~b~~~
b~~b~bb~b~b~b~b~b~~~b~~bb~b~~~b~b~~~bbb~bb~~~~~~b~b~~~~bb~~b~~~~~~b~~~~~~~b~b~bb~~~~~~bb~~bb~~bb~~~b~
b~~~~~~~b~~~~~~~b~~bbb~b~b~~b~b~~b~~~~~~~~b~~b~~b~~b~~~bb~~~~b~~b~~~~~~~~~~b~b~b~~b~~b~~~~~~bb~~~~~~~
~~~b~b~~~~~bbb~b~bb~~~~~b~~bb~~~~~~b~~b~b~~b~~~b~~~bb~b~~bb~~b~~~~b~b~b~b~~b~~~b~~b~b~b~b~bb~~~~~~b~~
bb~b~bb~b~~b~~b~b~b~~b~~b~b~~~~b~~~~~~~~b~~b~~~~~~~~b~b~b~~~~~~~~~b~~~~bb~b~~b~~b~~~bb~~~~bb~~b~~~~~~
~~~~~b~bb~~b~~b~~b~b~~b~b~~b~~bbb~b~~b~~b~b~~~b~b~~bb~b~~~b~~~b~~~~~~~b~bb~~~b~~~b~~b~bb~b~~b~b~b~~~b
b~b~~~~b~b~~b~b~~~bb~~b~~b~~~~~~~b~~b~~~~b~~~b~~bb~~~bb~~b~b~b~~~~b~bb~b~~~~~~~~bb~~~~~~bbb~~~~~~bb~~
b~~b~~b~b~bb~~b~~bbb~b~~~~~~~~~~b~~~b~~bb~~~~~bbb~~~~b~~~~~b~~bbb~~~b~~~~~bbb~~b~~~~b~~b~~~~~b~b~~~~~
~~~~~~~b~~~~~b~~b~~~~b~b~~bbb~b~~~~b~~~~b~~b~b~~~bb~~~~bbb~bbbb~~b~~b~~~~~~b~~~~~~~~~b~~~bbbb~~~~~b~b
~~~b~~~b~~~~~~~~b~~~~~~~~~~b~~~~b~~~~~bb~~~~~b~~~b~~b~~~~~b~b~b~~b~~b~b~b~b~b~~~~~~~~b~b~~~~~~~~~~~b~
~~~~~b~bbb~b~b~~~b~bbbbb~bb~~~~bbb~~~~b~~~~b~~b~bbb~~b~bb~~b~b~~~~~~~~~~~b~~b~~b~~b~~bb~~~~b~~~bbbb~~
~~~b~~~~~~b~~~~~~~~bb~~~b~~b~~~~~~~bbbbbb~b~~~b~~b~~~bbb~~b~b~~b~~~~~~~b~~b~~~~~~~~~~~bbb~b~b~~~bb~~~
~~~~~~bb~~~~~~~b~b~~~b~~~b~~~~~b~~b~~b~~bbb~~~~bb~~b~~~~b~~~~~b~~b~~~~~~~~~~~bbb~~~~~~~~~~bb~~~bb~~b~
~~~b~b~~~~b~b~~~~b~~~~~~~~~~~~~~~b~~~~~b~~~~b~~b~b~~~bb~b~~~~~~~~~bb~bb~b~bb~~~~bb~bbb~~bbb~~~~~~~~~~
b~bbb~~b~~~~~~b~b~b~~~~~b~~bb~~~~~~bb~b~bb~b~~~~~b~b~~~~~b~b~~~~~b~~~~~~~b~~bbb~b~~~~~~~~~~~~~~~~~b~~
~~b~~bbb~~b~b~b~~~~~~~~~b~b~~~~b~~~~~~~~~~~~~~bb~~~~b~~~b~~~~~bb~~~b~~b~~~~b~bb~~~~~~b~b~~b~~~~~~~~~~
~~~~~~~~~~~~b~~b~b~b~bb~b~~~bb~~bbb~b~~~b~bbb~b~~~~b~bb~~~bb~~~b~~~b~b~~~~~~~~~~b~~b~b~bb~~bb~~~~b~~~
~b~b~~b~~~~b~~~~bbbb~~~b~~bbb~~~~~~~~~~~~~~~b~~~~~~b~bbb~~~~~~~~b~~bb~~b~~~b~~~~~~~b~b~~~~~~~~~~~~~bb
~b~~~~~~~~~~bb~b~b~bb~b~b~~b~~b~~~~~~~~~~b~~~b~~~~b~~~~b~~~b~~~b~~~bbb~b~~~b~~~~b~b~~b~b~~~~b~b~~~~~~
~b~~~b~b~~b~b~~bb~b~b~bbb~~b~bb~b~bbb~~b~~~bbb~b~~b~~~bb~~b~b~b~~~~~~~~~~~~~~~b~~~b~~~~~~~~b~~~~~b~bb
b~b~~~~~~~~~~~~bbb~~~~~~~~~bb~~~~b~~~~~~b~~~~~b~bb~~~~~bb~~bb~~~b~bbb~~~~bbbb~b~~~~~~~bbb~~~~b~~~~~~b
~~~~bbb~b~b~b~~bbb~~b~~~~~~G~b~~~b~~~~~~bbb~~~~b~b~~bbb~b~~b~bb~b~bb~~~~b~~~b~~~b~~~~b~~~b~~bb~~~~b~~
b~~~~~~~~~bb~~~b~~~~b~b~b~~~~b~~b~~~~~bb~bb~~b~~~~b~~bb~~b~~~~~~b~~~~~~~~b~~~~~~~~b~b~~~~bb~~bb~~b~~~
~b~~bbb~~b~~~~b~~~b~~~~~~~b~~~~~~b~~~b~~bb~~~~~~~~b~~bbb~b~~~~~~~b~~~~b~~b~b~~b~b~~~~~~~~~~~~~~~~~~~b
b~~~~~~~~bb~~~b~~~~~~b~b~~~~b~~b~~b~~~~~~bb~~~~b~b~~bbb~~b~~~~b~b~~~~b~bb~~~~~~b~~~b~~bb~b~~~~~~~~~~b
b~~~~~bb~b~~~~~b~~bb~~b~bb~~~bb~~~b~~~b~~bb~~b~~b~~~~~~b~~~~b~~b~~~bb~b~~b~b~~~~~~bbb~~~bbbb~~~~~~~~b
~~b~~b~~~b~bb~b~b~~~~b~~~~~b~~~b~~~bb~bb~b~~~~~b~b~~~b~~b~~~~~~~~~b~b~~~b~~b~~~~~~b~~~~~~bb~~b~~b~~~~
~~~bb~~b~~~~~~~~~~~~~~b~~~~~b~~b~~~b~~~~b~~b~b~b~~b~~~~b~b~~~b~~b~~~b~bbb~~~~~~~~b~bbbb~~~~~~b~~b~~~b
~~~~b~~~~b~~b~b~~b~b~bb~~bb~bbb~b~b~bbb~b~bbb~b~~b~b~b~~b~~b~~bb~b~b~~~bbbb~~~~~~b~~bb~~b~~~~~~~~~~b~
~~~~~~~~~bb~~b~b~~~~~b~~~bbb~b~~~~~~~b~~bb~b~b~bb~~~~~~b~~~b~~~~~~~b~~~~~~b~bb~~~~bb~~~b~~~~b~~~b~b~~
~~~~~~~~~~bbbb~~~~b~~~~~~~~b~b~~b~~bb~~~~bb~bb~~bb~~bb~~~~~~~b~~~b~~~b~~~b~~~b~~~b~~~~~~bb~~~~~~~~b~b
~~b~~~bb~b~~~~~~~~~bb~~b~~~~b~b~~~~~~b~b~b~b~~~~~b~~~b~~~~~~~~b~~~bb~~~~bbbb~~~~bb~~b~~~b~~~~~~~~~~~~
~b~~~b~~~b~~~b~b~~~b~b~b~~~~b~b~b~~b~~~~b~~b~~~b~~~bb~bb~~~b~~~b~bb~b~bb~~~~~b~~~~b~bb~b~bbb~~~~~~~~~
b~~~~~~~b~bb~b~b~~~~~~bbb~~b~~~~~~~~~bb~bb~bb~~~~~~~~b~~~~~~b~bb~b~b~b~~b~b~~~~~~b~~~~~~~~bb~~bb~~~~~
~b~~b~bb~~~b~~~~~bbb~~b~~~b~~b~bb~~~~~b~bbb~b~b~~~b~b~b~~~~~~~~~bbb~b~b~b~~~~bb~~~~~bbb~~~b~~b~b~b~~~
~~~b~~~b~b~~~~~~~~~~~bb~~~~~~~~~~b~~b~~bb~b~~~~b~~b~~b~bbbbb~~~~b~~~~~~~~~~~~bb~~~~bbb~bbb~b~~~bbb~b~
~~bb~~~~b~~~~~~~~~~~~~~~~b~b~~b~~~~~~~~~~~~~~~b~bb~b~~~~~~b~b~b~~~~b~b~~~~~~b~~b~bb~~~b~~~~~~~bbb~~~~
~b~b~b~bbbbbb~~~b~~~~~b~~~~~b~~~~~~~bb~b~~~bb~b~~b~~~b~~b~b~b~b~~~~bb~~~b~b~b~b~~~b~b~~~~~~b~~~bb~~b~
~b~~~~~bbbb~~bb~~~~bbb~~~~~~b~~~~~~~~~b~b~~~b~b~~~~b~b~~b~~~b~bb~~~~~~~~b~~~~~~bb~~~b~~~~~bb~b~~~~~~~
~~~~~b~~~b~bb~~~~~~~~b~~b~bb~bbb~~~b~~b~~~~~~~bb~b~~b~~~~bb~~~~~~~b~~~~~~b~~~~~~~~b~~~~~~b~~~b~~~~bbb
b~~~~b~~b~~b~~~~~~~~~~~~~b~b~b~~bbb~b~b~~~bbb~~~~~~~bb~~~~b~~~~~b~~b~~~~~~~b~~b~~~b~~~~~~~~~~bb~b~~~~
~~b~~~~~~~~~~~~b~~~~~b~~~~~~bb~~~~b~~b~~~bbb~~~~~bb~~~~b~~~~b~~~b~bb~~~~~~b~~~~~~b~~~b~~~~~~~b~b~~~~~
~b~bbbb~b~~~bb~~~~~bb~b~~b~bb~bb~~~~b~b~b~~b~~~b~~~~b~~~bbbb~~~b~~b~~~~~~~b~~~~~~~b~~bb~bb~~~~bb~~~b~
~~~~~~~~b~bb~bb~bb~~~~b~~~~~b~~~~b~~~~~~~~~~~~~~~~~~~~~~~~~~b~~~~~~~~b~bb~~~~~~~b~~bb~~~~b~~b~~~~~~~~
~~~~~~~~b~~b~~~~~~~~b~bb~~~~~b~b~~~~~~b~~b~~bbb~~~~~~b~b~~b~~b~~~~~~b~~~~~b~~~~b~~~~~~~~b~~bb~~~~~~b~
~~bb~~~b~~~~b~~~~~~~~~~~~b~~~~~b~~bb~b~b~~~~~~~~~~~~~~~b~~~~b~~~~~~~bb~~b~b~~bb~~~bb~~~~~bbb~~~~~~~b~
~~~b~~~b~b~~b~b~~b~~b~b~bb~~~~~~~~~~~~b~~~b~~~~b~~~~~~~b~~~~~~~b~b~~~~~~~~~~b~bb~~~~b~bb~~~~~~b~~~b~b
~~~b~~b~~~bb~~~~~~~bbbb~~~~~b~b~~~~~~~b~~~~~~~b~b~~~~~~b~~~~bbb~~bb~~~~b~~b~~~~~b~~~~~~~~~~bbb~~~~~~b
~~~~~~~~~b~~~~~~bb~b~b~~b~~b~~~~~~~~~bbbb~~b~bbbbb~b~~~b~~~bbb~~~~~b~~~b~~~~b~~b~~b~~~b~~b~~b~~bb~~b~
b~~~b~b~~~b~~~~~b~~~~~~~~~~~~~~b~bb~bbb~b~~~~~~~b~~b~~b~~~b~b~b~b~~bb~~~~~~~b~b~~~b~~~~~~~b~b~~b~~~~b
~~~~~~~~b~~bbbb~b~bbbb~~b~~b~b~~b~b~~~b~bbb~~~~~~~~~~~~~bb~bbbbb~~~~b~b~~~~~~b~~~~~~~~~~b~~b~~~~~~~b~
b~~~~~b~b~~~~b~~~b~~~b~~b~~~bb~~~bb~~~~b~~~~~~~~~bb~~~bb~~b~~b~~b~b~bb~~~~~~b~b~~b~~bb~b~~~~~b~~~~~~~
~b~bb~~~~~b~b~~~~~~bb~b~b~~bb~b~bb~~~~~~b~~b~bb~~~b~~~~~~b~b~~~~~~~~~~~b~~~~~~~b~b~b~bb~~~~~bb~~b~~~~
~~~~b~b~bb~~~~~b~~~~~b~~~bbb~~~b~~~~~~~~~~~b~~bb~~~~bb~~bb~~~~~bbb~~~~~b~~~~bb~~b~~~~~b~bbb~~b~bb~~bb
~~~~bb~~~bb~~~~~~~~~~~~~~~~b~~~~~~b~bbb~~~~b~b~~~~b~~~b~~~~bbb~~~~~b~~~~b~bb~~~~~~~~~~b~bb~~~~~~~~~~b
~bb~b~bb~~~~~b~~~bb~b~~~bbb~b~~bb~b~b~~~~~~~bb~~~~~~~~b~~~bb~bb~~b~bb~~~~b~~~b~~~~b~~~~~bb~~b~~b~b~b~
b~b~b~b~~b~~~~b~~~~~b~bbb~~~~bb~~b~~~~~~~bbb~~b~~~~~~~bb~b~b~~~~bb~~~~~~~b~~~~b~~bbbb~~~~~~b~~~b~~b~~
bb~~~bbb~~~~~~b~~~~~~b~~~~b~~~~b~~~bb~~b~~~~~~~~~bb~~b~~b~~~~~~~b~~~~~b~~~~~~b~~b~~bb~~b~bbbb~~~~~bbb
~~~~~~~~~~~bb~b~~~b~~~~~~~~~~~bb~~bb~~bb~~~~b~~b~b~bb~b~b~b~~bb~~~~b~bbbbbbb~~b~~~b~~bb~~b~~~~bb~~b~~
~~~~~~~~~~~b~b~b~~~~~~~b~~b~~~~~~~~bb~~bb~~~~~b~b~~~~bb~~~~b~bb~~b~b~b~b~~b~~~~~~~~b~~~~~~~~bb~~bb~~b
~bb~~bbb~~~~~b~bb~b~~bb~~~b~b~b~~bb~b~bbb~~~b~~b~~~b~b~~~~~b~~~~bb~~bbb~b~~~~~b~~~bbbb~~b~bb~b~b~~~b~
~~~~~b~bb~~~~b~b~~~~~~~b~~b~bb~~~b~~bbbb~~~b~b~~bb~b~~bb~~~~bbb~~~~b~~b~~~~~~~~~~~bb~~~~bb~~~~~~~~~~~
~b~b~~b~bbb~b~b~~b~~~b~~~~~~bb~bb~b~~bb~b~b~bb~~b~~~~~~~~bb~b~b~~bb~b~~~~~b~~~~~~~b~~~bb~bb~~~~~~~~b~
b~~~~~~~~~~~b~~~~~b~b~~b~~~~~~~~~~~~b~~b~~b~~~bb~~~~~b~~b~~~~~b~~~~~b~bb~bb~~~~~~~~~b~bbb~bb~b~~bb~~~
b~bb~b~~b~~b~~~~~~~b~bbb~~~~bb~~bb~~b~~~~~~~bb~b~~~~~b~~~~~~b~~~~~~b~~~bb~bb~~~~~~bb~~b~~~b~~~~b~~~~~
~~~bb~~~~b~~~~b~~~~~b~b~~~~~b~b~~~~~~bb~b~~~b~~~~~~b~~~~~~~~~bb~~~~~~~~~b~~~~~b~~~~~~~bb~~~b~~~~~bb~~
bb~~b~~~~b~b~~~bb~~~~~b~~~~~b~~~~~~~~~~bbb~~b~~b~~b~b~b~~~b~~~b~b~~~~~~~~bb~bb~bbb~b~~~~~~bb~~~~~~~~~
b~~b~~~~~~~b~bbbbb~~~~~bb~~~b~bb~~~~~~~~~~~~bb~~b~~~~~~b~~~bb~~b~bb~~~~~~b~~bb~~b~~b~b~~~~bbb~~~~~bb~
~bbb~~~~~~b~~b~~~~~~~b~b~~~~~bb~b~b~~~~~bbb~~~~~~~b~~~~bbb~bbbb~bb~~~~~b~~~bb~~~b~b~~b~~~~b~~bb~~b~~~
bb~bb~bb~~bbb~~b~~~b~~~~b~~b~b~~~b~bbbbb~~~~~~~b~~~~bb~~b~~~b~~~~~b~~~~~~~~~~~~bbb~~~~~b~b~~~~~~b~~~~
