~b~~~bbb~~~bbb~~~b~~~~bb~~~~b~~~~~b~~b~bbbb~~~b~~~~~b~~~~~~b~~~~~b~~~~~~~~bb~~~~b~b~bbb~b~~~b~~~~~b~~
~~~b~~~~~~b~~~b~~~~~~~bb~~~b~~~b~~~b~b~~~~b~~b~~~b~~~~b~~~bb~bbb~b~~~bbb~~~~~~~~~~~~~~bbbb~~bbb~~~b~~
b~b~~~~Sbb~~bb~~~b~~~~~~~~b~~~b~~~~~~~~~~~~bb~~~~bbb~bb~~~~~~~~~~~~~b~~~~~~~b~~~b~~~~~b~~~b~~bb~~~~~~
~~~~~b~b~~b~~~~~~~~~bbb~~~~~bb~~bb~b~b~~~~bb~~~~b~b~b~~~~b~~~~~~b~~~~~~b~~~~~bbb~~~~b~b~~~~~~~~~~b~b~
~b~~~~~b~~b~b~bb~~~~~b~~bbbb~~~~~~b~~~~~~~~~~~bbb~~b~bb~b~b~~~~b~~~~b~~~bbbb~~b~b~~b~~~~~~~~b~~~~~~bb
~~~~bb~~~b~~b~~~~b~b~~b~~~bbb~~~b~~~~~~b~b~~~~~~~~b~~b~~~~~~bb~~~~~~~~~~~~b~~b~~b~~~~~b~~b~~~~~~~~~~~
~~~~~~~~bbb~~bb~b~~~~~~b~~b~b~b~~bb~b~~~b~bb~~~~b~~~b~b~~~bb~b~~b~~~~~~~~~~~~~~~~~b~~~bb~b~~b~b~~~~b~
~bbbb~~~b~~~~~b~b~b~~~b~~~~~~b~~bb~~b~~b~~bb~~~~~~b~~~~~bb~~~~~bbb~~~~~~~b~~bb~b~~~~~~b~~~b~~~~~~~~bb
~~~~~~~~~~bb~~~~~b~b~~b~~~~~~~b~~~~~b~bb~~~~~b~~~~b~~~~~~~b~b~~~~~~~b~b~bbb~~~~bb~~bbb~~b~~~~~bb~~~~~
~~~b~b~b~b~~~b~~~~~~~~~~~~~~~~~~~b~~~~bb~~~b~b~~~~bbb~b~~~b~~bb~b~~~~bb~~bb~~~bb~~~~~b~bb~~~~bb~~~~~~
~~~bbb~~~~~b~bb~~b~~~~b~~~~b~~~b~~~~~~~b~b~b~b~~bb~~~~~b~~~~bb~~~~b~~~~b~b~b~~b~bbbbbb~~~b~~bb~~b~b~~
~~~b~b~~~b~b~~~b~~~~~b~~b~~~b~~~b~bbb~b~b~~~~~~b~~b~~bb~~b~bbb~~~~~~~b~~~~~~~~~bb~bb~~~b~~~~~~~~~~~b~
b~b~~~b~~bbbb~~~b~~~~~~~~b~~~bbbb~b~~~~b~~~~~bb~b~~~b~~~~~b~~~~~~~~~~~~~b~~b~~b~~~~b~~~b~~~b~~~~b~~~~
~bb~~b~~~~bb~b~~b~b~~bb~~~~~~~b~~~~b~~b~b~~~~~b~~~~~~~~~~~bb~~~b~bb~~~~~~~~~b~bb~~~~~b~bb~~~~~~~~~~~b
b~~bbb~b~~~b~~b~~~~~bbb~~~~~~~~~bb~~bbb~b~b~~~~b~~~b~b~~~~~b~G~~~~~~b~~bbb~~~~~~~b~bb~~bb~~~~b~~~b~~~
b~~~~bb~b~~b~~~~b~~~bb~~~~b~~~bb~~~~~b~~~~~~b~~b~~b~~bb~b~~~b~~~~~~~~~bb~~~~~~~b~~~~~~~b~~b~~~b~~b~~~
~b~~~b~~b~b~b~~~~b~~~~~b~~~~b~~~~bb~b~~~bb~~b~~~b~~bb~~~~bb~~~~~~~bb~~~~bbb~b~~~b~bbb~~~~~~~~~~~~~b~b
~b~~~b~~~~~~~b~~~b~~~~~~~~~b~~b~~~~~~~~~~b~~~~~~b~~~~~b~~~~~b~~b~~~b~~~~~~~~~~b~~b~~b~~~~b~~~~b~~~bb~
b~bbb~~~~~~~~~~b~~bb~~~~~~b~~~b~b~b~bb~~~~~~~~~~~bb~~bb~b~bb~~b~b~b~~~~~~~b~~bbbb~b~~~~b~~~~~~b~~~~~~
~~~~~b~b~~b~~bb~~b~~~b~~~b~~~~~~bb~bb~~~~~~b~~b~~~~bb~~~~~~~b~~~~~b~~~~~b~~~~~~~b~~b~~b~~b~~~~~bb~bbb
~~~~b~~~bbb~~b~b~~~b~b~b~~~~b~~b~bb~bbb~b~~~~~~b~~bb~b~~b~~bb~~~b~~bb~~~~bb~b~~b~~~~b~bb~~~bbb~~b~~~b
~b~~~~~~~~~~~~bb~~bb~~~b~b~~~~~~~~~~~b~b~~b~b~~~~b~bb~b~~b~~~b~~~~~~~b~~b~b~bb~b~~~~b~~b~b~b~~bb~~~~~
~~b~~~~b~~~~bbb~~bbb~b~b~~~~~~~~b~~~b~~bbb~b~~~bb~~~b~~b~b~bb~~b~~~bb~~~~~~bbbb~~~bb~~~~b~~~~~bbbb~b~
b~~b~~~~~bb~b~~bbb~~bb~b~~~~~~~b~bb~~~~~~~~b~b~bb~~~~~~~~~~~~bb~~b~~~bb~bb~~b~~bb~~~bb~~~~~~b~~~b~~~~
~bb~bb~~~~~b~b~b~b~~~~~~~~b~b~~~b~~~bb~~~~~~~b~~~bbb~~b~b~bbb~~~~~bbb~b~~~bb~~~b~~~bb~~~~b~~~~~~b~~~~
~~b~~~~~~bbbb~~~~b~~~b~~b~b~~~~~bb~b~~~~~b~~bb~~b~b~~~~~~~~b~~bb~~~b~~~~b~~~~~~~~~~~~~b~~~~~~~~b~b~~~
~~bb~~b~~b~bbb~~~~~~~~~~~~~~~~~~~~~b~b~~~b~~~~~~~~~~~~~~~~~b~~b~b~~~~~~~b~bb~~b~~~b~b~~~~~~b~~~~~~~~~
bb~~b~~b~~~bbb~~~~b~~b~~~~~b~b~~b~bb~~~~b~b~~~~b~~~~~~b~~~~~~~b~~b~~b~~bbb~~~~~~~~~~~~~~b~~~~~~~b~~~~
~~~~~~~~~~b~b~~bb~~b~~~b~~~~~~~~b~b~~~~~bb~~~~b~~bbb~~~~b~~~~~~b~~~~~bb~b~~~~~~~~b~~~~b~~b~~~~b~~b~~~
~b~bb~~~~b~bb~~~b~~~b~~b~~~~b~~~~~~~~~~~~~b~~~b~~b~b~~~~~~bb~~~~~bb~~~~~bb~~~bb~~~~~b~b~b~~bb~~b~~~~~
~~b~b~~~~~b~~~~~b~~~~~~b~~~b~~~b~~~~~~~~~b~~b~~~b~~~~~~~~~b~~bb~b~~~~bb~~~~~~~~bb~~~b~b~~b~~b~~~b~~b~
~~~~~~~~~b~~~~b~~~~~~b~~~~~~~b~~~~bbb~~b~~bbb~~~~~~~~b~~~~~~b~~~~~~~~b~b~~b~b~~~b~bb~~~bbb~~~~bb~b~~~
~~~~bb~~~~b~bb~~b~b~bbb~~~~~b~~b~~bb~~~b~~b~~~~~b~~~~~b~~~~~~b~~~~~~b~b~~~~bb~~~~~b~~b~~~~~~~~~~b~~bb
~~~~~~b~~bb~~b~~~~~~~~~~~bb~~~~b~~~~b~~~~b~~~~~b~b~~~~~b~~b~bb~bb~~b~~~~bb~b~~~~~~~~~b~~b~bbb~~~~~b~~
bbb~~bbb~b~~~b~~bb~b~~~~~~~b~b~~bb~bb~~~~~~~~~b~b~~bbb~~~~b~~~b~b~~~b~b~bb~b~~~b~~~b~b~~~~bbb~~b~b~bb
b~~~~~bbb~~b~~b~bb~~~b~b~~b~b~~b~~~b~~~~bbbb~b~~~bb~b~~~bb~~b~b~~~~~bb~bb~~~~~~~~~~~bb~b~~b~b~b~~~~b~
b~~bb~~~~~~~~~bbb~b~b~~~~~~b~~bb~~~b~~bb~bb~~b~~~~~~~b~~~b~~~bbbb~bbb~~~b~b~~~~~~~~~~~~b~~~~~~~~~b~~~
b~~~b~~b~~~~~~b~b~~~bb~~~~~~~~~~~b~~~~~bb~b~~~~b~~~b~~~~~~~~~~~~~b~~b~b~~~~~b~~~~~~~~~b~bb~~b~b~~~~~~
~~~~~~b~b~~~~~~bb~~bb~bbb~bb~bb~~~~~~~bbb~~~~~~~~~~~bb~b~~b~~bb~bbb~bb~~b~~~~~~b~~~~~~~~b~~bb~b~b~~~b
~~~~~~b~~b~~~bbbb~~~~~~~~b~~b~~~~~~b~~~~~bbb~b~~~b~~b~~b~~~~b~bb~~b~~b~b~~b~~b~b~~~~~~~b~~b~~b~~~b~~b
~b~~~~b~b~~b~bb~~~b~~~~b~~b~~~~b~~b~~b~b~~b~~~~~~~~~~~~~~~~~~b~~~~b~~~~~~~~~~~~~~~~~bb~b~~~~b~~~~b~~~
b~~~b~~bb~~b~~~~b~b~b~bbb~~b~~b~b~~~~~~~~~~~b~~bbb~~~bb~~b~~~~bbb~~~b~bbbb~~~~~b~~~~~~~~~~~~~b~b~b~~b
~b~~~b~~~~~~~b~~~~bb~b~~b~~~~~b~b~b~b~b~~~bb~b~~~~~~~b~~b~b~b~~b~~~bb~~bb~~b~~b~~~~b~b~~~bb~~b~~~~~~b
~~b~~~~~b~bb~b~bb~~b~b~~~~~~~~~bbb~b~~bb~~~~~b~b~~~~~~~bb~~~~~~b~b~~b~~bbb~~~b~~~~bb~~~b~~b~~~~~~b~~~
~~~~~~~~~~~~~~b~~bb~b~b~~~~~bb~bb~~~~~~~~~bb~~~bb~~~~~~~b~~bb~~b~~~~~~b~~~~~b~~~~b~~~~~bbb~~~~b~b~b~~
~~~~~~b~~~b~~bb~~~~~bb~~~~~~b~~~~b~~~~~~b~~~~b~~~b~~~bb~b~~~~b~~~~b~~b~~~b~b~b~b~bb~~~~~~~~bb~~b~~~b~
~~~~~~~~~~b~~~b~~~b~bbb~~~~~b~~b~b~~~b~~~~~~~bb~b~b~~~~~~b~b~~b~~~~~~~~~b~~b~~b~~~bb~~~~~~b~~~b~bb~~~
~~bb~b~~~~bb~~~b~~b~~~~~~~~~~~~b~~bb~~~b~b~~~~~~~b~~b~b~b~~bbb~~~~b~~~bbb~~~b~b~b~~~~~~~b~~~~~~bb~~b~
b~~~b~~b~~~~~~b~bbbb~~~~~~b~~b~~~~~~~~~~~~~~b~~~~b~~~~b~b~~~~~~~b~b~b~~~~~b~~~~~~~~~~~~~bbbbb~~~~b~~~
bb~~~bbb~~~~~~~b~b~~~b~~~~~~~~bb~~~~b~~~~~~~~~b~~~~b~~~b~~~b~bb~~~~~b~b~~~~~~b~~~~~~bb~b~~~b~~~~b~bbb
~~~~~~bb~b~~~~~~b~~b~b~~~~b~~~~b~~~b~bbb~~~~~~bb~b~b~~bbbb~bb~b~~~b~~~bb~~~bb~b~~~~~b~~b~~~~~~~~~~~~~
~~b~~bb~bbbbb~~bb~~~b~~~~~bbbb~~~b~~b~~~~bbbb~b~~~~b~b~~bbbbb~~~~~b~~b~~b~bbbb~~~~~b~~~~bb~~~~~bbbbbb
~~~b~b~~~~~~~~~~~~b~b~~~~~~~~~~~~~b~b~bb~~b~~~~b~~~~~b~b~bb~~~b~~bb~b~~~~b~~~b~~~~~~b~b~~~~~~b~b~~b~~
~~~~~~b~~~~~~b~~~~b~~~~~~~b~~~~b~~~~~~~~~~b~b~~~~~~b~bb~~bb~b~~b~~b~~b~~~b~bbb~bbb~bb~~~b~~~~~~b~~~bb
bb~~~~bbb~b~~~b~~~~~~~~b~~~b~~b~b~~b~~~b~b~b~~~~~~b~bbb~~b~bb~~~~bb~~b~~~~bb~~~bb~~~b~~~bb~~~b~~~~b~~
~~~bb~b~~~~~b~b~b~~~~~~~~~~~~b~b~~~~b~b~b~~b~~b~~~b~~~bb~~b~b~~b~bbb~b~~~~~~~~bbbbbb~~b~~~~~~~~~~~~b~
~~~b~~~~bb~b~~~~~b~~~~~~~~b~~~~~~~b~bb~~~~b~~b~~~~b~b~~bbb~~~~~b~~~bb~~~~b~~~~~bb~bb~b~~~~~~~~~~~~~~b
~~b~bbb~~~~bbb~~b~~~~~~~~~~~~~~~~~~~~bb~~~bbb~b~~~~~b~~b~b~~b~~~~~~~bb~~~~~~~~b~~~~b~~~~~~b~~~b~b~~~~
bb~~bb~~~bb~~~~~~~b~~~~~~bbb~~~b~b~~~~bb~bbb~~~b~b~~~bb~~~~~b~~~b~~~~~~bbb~~~~b~b~~b~~~~~b~~~bbb~~bb~
bb~~~~b~~~~~~~~~~b~~b~~~bb~b~b~~~~~~~~b~~b~~b~b~~bb~~b~b~~~~~~b~~~~bbb~~~b~~~~~~b~b~~~~~~b~~~~~~~~~~b
~~b~~~b~~~b~bb~~b~b~b~~~~bbb~bb~~~~~~~bb~b~~~~~~~~~~b~~~b~~b~b~b~~b~~~~~~~~~~b~~b~~b~~~~~~~b~~~~b~~~~
~~~~b~~~b~b~b~b~~~b~~~b~~bbb~bbbb~~b~~~~b~~b~~~~~b~b~~~~b~~~~b~b~b~~~~~~~~~b~b~~~~~bb~~b~~b~~~b~~~b~~
~bb~~~b~~~~bb~~~~b~~~~b~bb~~b~~~~~~~~b~~~~~~~~~b~~~~~~~~~~b~~~~~bbb~~b~~b~~b~bbbb~~~~~~bb~b~~b~~~~bb~
~~~b~~b~~~bbb~b~~~~~b~~~~bb~b~~~~b~~~~~b~~~b~~b~~b~~b~~~~~~bb~~~~~bb~~b~~~~~~~b~~b~~~~~~~~b~b~~~~b~~~
b~~~~~b~b~~b~b~~~~~~~~b~~~b~~~~~~~~~~b~~~~b~~bb~~b~~~~~~~~~~~bb~~b~~b~~~~~~b~b~~~~bb~~~~~b~bb~~b~~~~b
~~bbb~~~b~~~~b~~~~~~b~b~b~~~~~~b~b~~~b~~b~~bb~~bb~~~~~~~~~~~~~b~~~~b~b~~~b~b~~bbb~b~~~~~~b~~~bb~~~~~b
b~~bbbb~~~~~~~bb~b~~bb~~~~~~~~~~~~~~~~~~~~~b~~~~~~~~b~~~b~~~~b~bb~b~~~b~b~b~~~~~~b~b~~~~bb~b~~~bb~~~~
~~bbbbbbbb~~~~~~b~~bbb~~~~~~b~~~~~b~~~~b~~~~~b~~~~~~b~~b~~~~~bb~~~~bb~~b~b~bbb~~b~bb~~b~~~b~~b~~~~~bb
~~~~~~~~bbb~~bbb~~~~~~bb~~~~~b~~~~b~~~~~~~~~~~~b~b~~~~b~~b~~~b~~~~~~~~b~~~~~bb~~~~~~~~~~~~~~~~~b~bb~~
~~~b~~b~~~b~~~~~~~~b~~b~~~b~~~~~~b~~~bb~~~~~b~~b~~b~~b~~~b~~b~~~b~b~b~bbb~b~~b~~~bb~~~b~bbbbb~~~~bb~~
~~~~~b~b~bb~b~~~b~b~~~~~b~~~~~~~~~b~bb~~~~~b~~bb~~~~~~~~~~b~b~~bb~~~~~b~~~~~~b~b~~b~~~~~~~b~bbb~~b~~~
~~b~~~~~b~b~~~~~~~~~bb~~~~~b~~~~b~~~~~~~~~~~~~~~bb~~~~b~~~~~~bb~b~~bb~b~~~~~~~~b~~~~b~~b~b~~~~b~~~b~~
~~b~~~~b~~~~~~b~b~~~~~~~~~~b~~~b~b~~~~b~bb~~~~~~b~~~bb~~~~b~bbbbbbb~~~bb~~b~bb~~~~~b~~b~~~bb~~bb~~~bb
~~b~~~~~~~~~b~~~~~~~~~~b~b~b~~~~~~bb~~~bb~b~b~~~~~b~~~b~~~b~b~~~~~~~~bb~~bbb~bbbb~~~~~~bbb~~~~~~~b~~b
b~~~~b~~~~b~~b~~b~~~~~~~~bb~~~~~~b~~~~~b~~~~~b~~b~~~~bb~~bbb~~bb~~~~bb~~~b~bb~~b~b~~~b~~~~~~b~~~~~~~b
~~~~~~~bb~b~~~b~~~~~b~~~~~~~~bb~~~~~~~b~b~~bb~~~~~bb~b~~b~~~~~~~~~bb~~~b~~~~b~~b~~b~b~bbb~b~~~~bbb~b~
~b~~~~b~~~~b~~bb~~bbbbbb~~~~~~~~~~~b~b~~~~bb~~~~~b~b~~~bb~bb~~~~~~~~~~~~b~bb~~b~~~~~bb~~~~~~bb~bbb~~~
b~~~~~~~b~b~~~~~~bb~~~b~~bb~~~~~~b~~b~~~~b~bb~b~~b~~b~~~~~~~~b~~~~~~~~~~~~~~~~~~bbb~~b~bb~~~b~b~~~~~~
b~~~~b~~~~bb~~~~b~~~bb~bb~~bbbbb~bb~~~~~~b~b~~~b~~~~~~~~b~~~bb~~~~~~~~b~bbb~~~b~b~~~bb~~~~~~b~~~~b~b~
b~~~b~b~b~b~~~bb~b~b~~bbb~~~~~~~b~b~~~~~~~~~~b~~~b~~~~~~~~b~b~~~b~~~~~bb~~~~~~~~~~~~bb~~~~~~~~b~bbb~~
~~b~~bbb~b~b~~~~b~~~~~~bb~~~~~~b~~~b~~bb~b~~bb~~~~~~~~~~bb~~~~~~~~~~~~~~~~~~~~~~b~~~~~~~bbb~b~~~~b~~~
~~~~~~~~~~b~b~~~~~bb~b~~b~~b~b~~~~~~b~~~~~~~~~~b~~~~bb~~~~b~~~~~~b~~~b~~~b~~~~~~~b~~b~~b~~~~~bbbb~~~~
~b~b~~b~~~bb~b~~~~b~~~~~b~~~~bb~b~~~~~bb~~~~b~b~~~~b~~~~~~~~bb~~~b~~~~b~~b~~~b~bb~~~~~b~bb~~~~bbbbb~~
~~~b~b~~~b~~~bb~~~~b~~~~~b~~~~~b~~~bb~~~b~b~~~~b~~~b~~~~b~b~~~~~~bb~~~~~~bb~~~~~~~~~~~b~b~~~~b~bb~bb~
~~~b~~~~~~~b~b~~~~bb~~~~b~b~~~~bb~b~~~~b~bbbb~~~~~b~~~~~~~~~b~~~b~b~~bb~~b~b~~~b~~~~~~~~~b~~~~~b~~~~~
b~~~~~~b~~b~~~b~~~~~~b~~~~b~b~~~b~~~~~bbb~b~~~~~b~~bbbb~~~b~bb~~~b~~~~~~~~b~b~~~~~~~~b~b~bb~~b~b~~~~~
~~b~~~~~b~b~~b~~~~~bb~~b~~b~~~~~bb~bb~~b~~~~~bb~~b~b~~b~~~~bbbb~b~b~~~~b~~~~~~b~~~b~~b~~~b~~~~~~~~~~~
b~~~~~~~~~~~~~bb~b~~~~~~~~~~~b~~bb~~~~bb~~~b~~~b~~~b~~bb~~~b~b~~~~b~b~~bb~~~~b~b~~bb~~b~bbb~~~~~~~~~~
~~~~b~~b~b~~~bb~~b~~b~~~~~~b~~~~~~b~~~b~b~~~~~~~bb~b~~~~~~~bb~bb~~b~~bb~~~~~bb~~~~b~~~~~~~b~~~~b~~~b~
b~~~~~b~b~bb~~~~~~b~~~b~b~b~~b~~~~b~~b~~b~~bb~b~bbb~~~~~~bb~~~b~~~~b~~b~b~b~~~~~~~bb~~b~bb~~~~b~b~~b~
~~~b~~~bb~b~~~~~b~~~~~~~bb~b~~~~b~~b~~~~~~~~~~~~bbb~~~~~bb~~b~~~~~~~~~~b~~b~bbbb~~b~~~~~~~~~~~bb~~b~b
b~b~~b~~b~b~~~~b~~bb~~b~~~b~b~~~~b~b~~bb~b~b~~~~~~~b~~~~~~~~b~~~~b~~bb~b~b~~b~~~b~bb~~bb~bb~~b~~~~~b~
~b~~~~~~b~b~~~~~~~~b~~~~~~~~~~bb~~~~~~~bbbb~bbb~~~b~b~~~~~~b~b~~b~~b~~b~~~~~~~~bbb~~~~~~bbb~~~~~~b~b~
~b~b~~~~~~~~~~~~b~~~b~b~b~~~bb~b~~~~~b~~b~b~~~bb~~b~~~b~~b~~~~b~~~b~~~~b~~b~~~b~bb~b~b~~~~~bb~b~b~b~b
~b~~bb~~~~~~~~~bb~~~~~b~b~~bb~~b~~b~b~~~b~~bb~~~~~~b~~~~b~~~b~~b~~~~~~~~~~bb~~b~b~~~~bb~~~~~~b~~bb~b~
~~~~~~~~~~bb~~b~~~~~b~~~bb~b~~~b~~~~~~~~b~b~~bb~~b~~~~~~~b~~~~b~b~~b~~~~~~~~b~~~~~~~~~bb~~~~b~b~~~bb~
~~~~b~~b~b~~~~~~~~~~~~~~~~~~b~bb~~bb~~~~b~~~~~~~b~~~b~~~b~~b~~b~b~b~~~b~~~~~bb~~~~bb~~b~~~~~~~~b~~b~~
~~~~bb~~bbbb~b~bb~bb~~~b~~~bb~b~~bb~~~~~~~~~b~b~~~b~b~b~bbbb~~b~~~~b~~bbb~b~~~b~~~~~~~~~bb~~~~b~~~~~~
~~~~~~~~~b~~~b~~~bbb~~~~~~~~~~b~bb~b~~~b~~b~bbb~bbbb~bb~b~~~~~~~bb~b~b~~~~~~b~~b~bbbb~b~~~~b~bb~~~~~b
~~~~~~~~b~~~b~~b~~~b~~~~~~~bb~b~~b~~~~~b~b~~~b~~b~~~~~~~~~~~~~~~~~b~~~~b~b~b~b~~~~~~~b~~~~~~~~~~~~~~~
~b~b~~~b~b~b~bb~bb~~~b~~b~~~b~b~~~~~~b~~~~~~~~~~b~b~~~b~~~~~~b~~~~~~~~~~bbb~~bb~~~~b~~b~~~~~bbb~b~~b~
