~~~~bbb~~~b~~bb~~~b~~b~~bb~~~~bb~~~b~~~~~b~~~~~~~~~~b~~~~b~~~b~~~~~b~~b~bb~~~~~b~b~~b~~~~~b~~~~bbb~~~
~b~~~~~~b~~~b~~~~~~b~~b~~~b~~~b~bb~b~~~~~bb~~b~~~~~~~~~~~bb~~~~~~b~~~~b~~~bb~~b~~b~bbb~~~b~bb~~bb~bbb
b~~~~b~~b~~~~~~~~bb~~~~~~~~~b~bb~~~b~~b~~~b~b~~~b~b~~~b~~~~b~~~~~~bbb~~~~~~b~~~~b~~b~~~~~~b~b~~~~~~~~
~~~~bbb~bbb~b~~b~b~~~~~~~~~~bb~~~b~b~bb~~~~~b~bb~b~~~~bb~~~b~~~~b~~~b~~~bb~b~~~~~b~~b~~~~~~~~~~~~~~~~
bbb~b~~b~~~bb~bbbb~~bb~~~~~~~~~~b~~b~~~~~b~~~~~b~~~b~b~b~~~b~b~~~~~~bb~b~~~b~~b~~~bb~~~~~b~~~b~~~b~~~
~~~bb~~~~~b~b~~~~~~~bbb~~~~b~bbbb~b~~~~~~b~b~~~~~~~~~~b~b~~~~b~~~~~bb~~~b~~~~~~~~~b~~~bbbb~~~bb~~b~~b
~~~~~~~~~b~~~b~~b~b~b~~~~~~~b~~~~~~~~~b~~~~~~~~~~~~~b~~b~~bbb~b~~b~b~~~~~~b~~b~~~~b~~~~b~~~~b~~~~~~~~
~~~~bb~~~~b~~b~~~~~~~~bb~~~b~~~~~~b~b~b~~~~b~~b~~~~b~~bb~~~~bb~~b~b~b~~~~bbb~~bb~~~~~~~b~b~~b~~b~~~~~
~~~b~b~bb~~~~~~~~~b~~~~b~~~~b~~~~~~~b~~b~~b~b~~b~~b~b~~bb~~b~~b~~~~~b~~b~~~~~bb~b~bb~~~bb~bbbb~~~b~~~
~b~~~~~~~~~~~~~~b~~b~~~b~~~~~~~~b~~~~~~b~b~bb~~bbbb~~b~b~~~bb~b~~~~~~b~~~~b~~b~~~~~~~~~bb~bbb~b~b~~~~
~~~~~~~~~~~~b~b~~~~~~bb~~~~b~~~~~b~~~~b~b~~~~~~~~b~~~b~~~bbb~b~b~~bb~~bbb~~~~~~~~b~~~b~~~~~~b~~~~~~b~
~b~~~b~b~~~~~~~~~~b~b~b~bb~bbb~~~b~~~~bb~~~~~~~~~~~~~~~b~~~~~bb~~~b~~b~~~~~~~~bb~~~b~~~b~~b~b~~~~~~~~
b~~~b~bb~~~~~~~~b~~~~~~~b~~~~~~~~~~b~bb~~~~~bb~~~~~~~~bb~~~~~b~~b~~b~~~b~~~~~~~~~~~b~~~~b~~~~~bb~~~~b
bbb~b~~~b~~~~~~~~~b~~~bbb~b~~~b~~~~~~b~~~~b~bb~~~~~~b~~~~~~b~~b~~b~~~~bbb~~~~~~~b~~b~b~~b~~bb~~b~~~~~
bbb~b~~~b~b~b~b~~~~~~~b~~~b~~b~~bb~bbb~~~~b~~bb~~~~~~~~~~~~~b~~bb~~~~~~b~~~~~~~b~~~~~~~~~b~~b~~bb~bb~
~bbb~~~bb~~~~~~b~~~~b~~~bb~b~bb~b~b~~~~~b~b~~~~~~b~~~b~~~~~~~~~~~bb~~~~b~~b~~~b~~~~~bbb~~~~~b~~b~~bb~
~~~~b~~~b~~~~~b~b~~~~~~~~~~~~~~~~~~~~~b~~b~b~~~~b~~~b~~~bbbb~~~~bbbb~bb~~b~~~~~~~~~b~b~~b~~~~~~~b~b~~
b~~b~bb~~b~~bb~b~bb~~~~~b~~b~~~~~b~~~~~bbb~bbb~b~bb~~~~b~b~~b~b~b~~~~~b~~~b~~b~~~b~~~~~~~b~~b~b~b~~~~
~~~~~~~~~~~~~~~b~~b~~~b~bb~~b~~~b~~~~~~~~~~~~~bbb~~~~~~~~~~~b~~~~b~b~~~~~~~~~b~~~~b~bb~~~~b~~~~~b~~b~
~~~~bb~bbb~~~~~~~~~bb~~b~~~~~~bb~~~~b~~~~~bbbbbb~~b~b~bb~~b~~~~~~~~~~~~~~b~~~~~~~~~b~~~~~~b~b~~~bb~~~
~~~~bb~~~~~~~~b~~bbbb~~~bbb~~bb~b~~b~~~b~b~~~~bbb~~~~b~~~~~~~~~b~~~~~~~~bb~~bb~~~~~b~b~b~~~~~bb~~~~~~
~~~bb~b~~~~~b~~~~~~b~~b~~~~bbb~~~~~bb~bbb~~b~b~~~~b~~~~~~~~~~~~~b~bb~~~b~~~~bbb~~b~b~b~~b~~b~~~~~~~~b
b~~~b~b~~b~b~~~b~b~b~~~b~b~b~~b~~bb~~~~~~~bb~~b~~~~~~~~b~bbb~~~~b~~~bb~~~~~~b~b~~b~~~~b~~b~~~b~~~~~~b
~~~~~b~~~~~b~b~~~~~b~~~~b~~b~~~~~bb~~~~~~~~~bbb~b~bbb~~bbb~~b~b~~~~b~~~~~bb~~b~b~b~bb~~~~~b~~~~~~bb~~
~~~b~b~~~~b~~b~b~b~b~b~~~~~~~~~~~b~~~~b~~b~~~bb~~~~b~~b~~~~~b~~~~b~~~~~~~b~~~~~b~b~~~~b~~~~~~bbb~~~~~
b~~~b~b~~~bb~b~~bb~~~b~~~~~b~~~~~b~~~~b~~~b~~~b~~~~~~bb~~bbbb~~~~~~b~b~~~b~b~~~~~~~~b~b~b~~b~bb~~~b~~
~b~b~b~bb~b~bb~~~~~bbb~~b~b~b~bb~~~b~~~~~b~~b~~~~b~~~~b~~b~bb~~bb~b~~~~~~b~~~b~~~~~~~~~~b~~~b~b~~~~~~
~~b~~~bb~~b~b~b~~b~~~~bbbbb~~bbbbb~bbbb~b~bb~~bb~~~~b~bb~~~~b~b~~~b~~~~~~~~~~~b~~~~~~~~~bb~~~b~~~~bbb
~~~~bb~~~~~~bbb~~b~~bb~~~~~~~~~~~~~~~~~~~~~b~~~~~~~~b~bbb~~bb~~b~b~bb~bb~~~~~~b~~bbb~~~~b~~~~~~~~bb~~
bb~~b~~b~b~~~~bb~~~~~b~b~~~~~~b~~~bb~~bb~~b~~bbb~bbb~b~~~~bbb~~~~~~~~b~b~~~~~~bb~~~b~b~~~~bb~~~b~~b~~
~~b~b~b~~b~~~~~~~~~~bb~~~~~~~~b~~~~~~~~bb~b~~bbbb~~~~~~b~~~b~~~b~~~~~~~~~~~b~~~b~~~~~~~~b~~~b~~~b~~~b
bb~~b~~~~~bbb~bb~~~b~bb~~~bb~bb~~b~~b~bb~~~b~~~bbb~bb~~~~~~~~b~~bb~~~b~~~~~~~b~bb~~~~~~~b~bb~~b~~~~~~
bb~~bbb~~~~~~~~b~~~~b~~b~~~~~b~~~b~~~~~~bb~~~~~b~b~~b~b~~~~~~b~~b~b~b~~~~~~~~~~~~~b~~~~~~~~~~~b~~b~b~
~~bb~~~b~~~bb~b~~~b~~~~bb~~~bb~~b~~~~~~~~~~~~b~~~~~~~bbb~~~b~~~~~~~~~~bb~~b~~~~~~~~bb~~b~~~~~~~~bb~b~
~~b~b~~~~~~b~~b~b~~~~~b~~~~b~~~~~~~bbb~~~~bbbbb~b~~~bbb~~bb~bb~~~~~~~~~~~~b~~~~~~~~b~bb~b~~~~b~~~~b~~
b~~~bb~~bbb~~~~~bb~~~~b~bb~~~~b~bbb~~b~~~~~b~~~~b~b~~~~~~~bbb~~~~~~~~~~b~~~~~~~~~b~~~~~~~bbbbbb~~~~bb
b~bbbb~b~~~~b~~~~b~~~~bb~~~b~~~~~b~b~bb~b~bb~b~b~b~~b~~~~~bb~b~~b~~~~b~~bb~~~~~~b~~~~~b~~~b~bbb~b~~~b
b~~~~~b~~b~~~~~~~~~~~~~b~bb~b~bb~~~~b~b~~~bbb~bb~~bb~b~b~b~~~~~~~b~bbb~~~~~~~~~~~b~~b~~~b~~b~bb~~~~~~
~b~~~~~b~~~~~bbb~~~b~~~~b~~~~~~b~b~~~b~~b~bb~~~~~~~~b~b~b~b~b~~b~b~~~~~~~~~~~~~~~~b~b~b~~b~~b~b~~b~~~
b~~~~~bb~~~~~~~b~~bb~~~~~~~~~b~~b~~~~~~~~~~~bbbb~~~~b~~bb~~~~b~bbbb~b~~b~b~~b~b~b~b~bb~~~~~~~~bb~b~bb
~b~b~~b~~~~~~b~bbbbbb~~~~b~~~~bb~b~~b~~~b~~b~b~bbb~b~~~~~b~~~~~~b~~~~~~~b~~b~~b~~~~~~b~~~~~~~b~b~~~~b
~~b~~b~~bb~~~b~~~~~~b~~~b~~~~~~~b~~b~~b~~~~b~bb~b~bb~~~~~~b~~~~bb~~~~b~b~b~~b~~~~~bbb~~~b~~bb~~b~b~~~
~~b~~~b~~~~b~b~~~~~~~~~bbb~b~~~~bbbb~~b~~~~~~~~bb~~~b~~~~~bb~b~~b~~~b~~~~~~~~~~bb~~~~~~bb~b~~b~b~~~b~
b~~~~~b~~~~~~~~~~bb~bb~~bbb~bb~~~~~bb~~~~~b~~b~~~~~~b~~~~~b~bb~~~~bb~b~b~~~~b~~~b~~b~~b~~~b~~~~~~b~b~
b~~bbb~~b~~~~bb~~~bb~~~~b~b~~~~~b~~~~~~~~~b~~~b~~~b~~b~bb~~~~~~b~b~b~~~~~~~b~~~b~b~~~b~b~b~G~~bb~~~bb
~~~~b~~~~~b~~~bbb~~bb~~~~~~bbb~~~~~~~~~b~~~~~~bb~~~~b~~~~bb~~~b~~~~~~~~~~~~~bb~~~~b~b~~b~~~~~~~~~~~~~
~b~~~~bbb~b~b~~~b~~~~b~~~b~~~b~b~bb~~~~~~~~~~b~~~~~~b~~b~~b~b~~b~b~bb~~~b~~~~~~b~~~~b~~~~~~~~~~~~b~~~
b~bb~~~~~~~~~bb~~~~~~~~~~b~~bbbb~~~b~~~~~~~b~b~~~b~~bb~b~~~~~~~bbbb~~~~~b~b~~b~b~b~~~~~~b~b~~~~~~~bb~
~b~~~bb~~~~bb~b~~~~~~~bb~b~~~~b~~b~~~~~~b~~~~b~~~~b~b~~~b~b~~~~~~~~~~~~~~~~~~~~~b~~bb~~b~~~~~b~~~~~b~
~b~b~~~~~~~~~~b~~~~~b~~~bb~~~~bb~~b~~~~~~~~~b~~~~b~~~~~~~~~~~b~~~~~~~b~~~~~b~~~~~~~~b~~~~~~~~~~~b~~~~
b~~~~~~~~~~~~~~b~~b~~b~~b~~~~~b~~~~~~~b~~b~~bb~b~~b~b~b~b~~b~b~~~~~~~~~bb~~bb~~~~b~~~b~~b~~b~~~~bbb~~
~~~~~bb~~~~~~~~~b~~b~~~bb~bb~~b~bb~~b~b~~bb~~~b~b~b~~bb~b~~~b~~~~~~b~b~b~b~~~b~~b~~b~~b~~~~~b~~~~~~~~
~~~bb~bb~~~bb~~~b~~~~~~b~~~~b~b~b~~~bb~~b~~~~~~~b~~~b~bb~b~~b~~~~~~bbb~~~b~~~~~bb~b~bb~~~~~~~~b~~~~b~
~bbb~b~~~~~bb~~~~~~~~~~~~~bb~b~~~~b~~~~~~~~~~~~b~~~~bb~~~~~~b~bb~~~b~~~~b~~~b~~~~~~~~~~bb~~~~bb~~b~~~
~~~~~~~~~bb~b~~~bb~~~~b~b~b~b~~b~~~~~~~~~~~bb~~b~b~~~~~~~b~~b~~~~b~~~~~b~bb~~~b~b~~b~b~b~~~b~~~b~b~~~
~bbbb~~~b~~~~b~~~b~~bb~~~~~~b~~~~b~bb~~~bb~bb~~~~b~~b~~~b~b~~b~b~bb~~~~~~~~~b~b~~b~~~b~~bbb~~~~~~b~bb
~~~~b~~b~b~~~~b~~~~b~~~bb~bb~bb~~~~~b~~~b~~~~~~~~~b~~~~~~~b~~~~b~~~~~~bbbb~b~~b~~~b~~~~~~b~~b~~~~~bb~
bb~~~bb~bb~b~b~b~~bbb~~b~~~b~~~b~~~~~~b~~~~~~~~~b~~~~~~~~~~b~~~b~~b~~b~~~~bbbbbb~~~~~~b~~~~~~~~~~~b~~
~b~bbb~b~~~~bb~~b~~b~~~b~~~~~~~~~b~b~bbbb~b~~~~~~~~~~~~bb~bbbb~~bbbbb~~b~b~~~~~~b~~b~~~b~b~~~~b~bbb~~
b~~~~~~~~bbb~~~~~~bb~~~b~~bb~~~~bb~~~~~~b~~~b~b~b~~b~~~b~b~~~b~b~b~~bbb~~~b~~~~b~~b~b~~b~~~~b~~~~~~b~
~~~~~~~~~~~~~~b~~bb~~b~~b~~~~~~~~b~~~~~bbb~~~~~~~b~bb~~~~~b~~~~~~b~~bb~~b~~b~~b~~bb~~~b~b~~~~~bb~~~~b
~b~b~~~~~~~~~b~~b~~~~~b~~~bb~~~~~~~b~~~b~~~~~~~~~b~b~~b~~b~~~~~~b~~~~b~~~~~~b~b~b~bb~~~~b~~~~~bb~~~b~
~~~b~~~~~~b~~bb~b~b~bb~~~~~~~~~b~~bb~~~~~~b~~~~~~~b~~b~bb~~bb~~~~~~bb~bb~~~~b~~~~b~~~~~~~~~~~b~~~b~b~
~~~bb~~~~~~~~~~bb~~~~~b~~~b~b~~~~~~~~b~~bb~~~~b~~~b~b~~bbb~~~~~~~~bb~~~b~~bb~~~~~b~~~b~~b~~~~bb~~~~b~
b~~b~~~~bbb~~~~~~~~~~~b~~~~~~~~b~~bbb~~~~~~~~b~~~b~b~~bbb~~~~b~~~~~b~b~~~b~~b~b~~~bb~~~bbb~~b~~b~~~~b
~~~~~~bbb~~bb~~~~~~~b~b~b~b~~b~b~~~~~~~~~~~~b~b~~~~~~~~~~~~~~~~b~~~bb~b~~~~~~~~~b~b~~~~~~~~b~b~~~~~~~
~b~~bb~b~~~~~~b~~bbb~~~b~~~~bb~b~~~~~~~~~~~~~~~~bb~~b~~~b~~~~b~~bb~~~~~~~~~~~b~~~~~~b~~~~~~~~~~~~~~b~
~b~~~~~~~~~~~~~~b~b~~b~~~~bbb~~~~bb~~~~~~~~~~~~b~b~~~~~~b~~~~bbb~b~b~~b~b~~~~~~b~~b~b~~~~~~b~b~~b~~~b
~~~~~~~~bbb~bb~~~~~~~b~~~~~~~~~b~~~~~b~~~b~bb~~b~~~~~~~~b~~~~~~~~b~b~~~~~b~b~~~~~b~b~b~bbbbb~b~~~b~~~
~~~~~~b~b~~~~~~~~~~~~bb~b~bbb~b~~~b~~~~~b~~~~~~~~~b~~~bb~~~~~~b~~~b~~~~bbb~~~b~~~~~b~bbb~bb~~~~~~~~~~
bbb~~~~~~~b~~bb~~~~~~~~~~~~~~~~~~b~~~b~~~b~bb~~b~b~~~~b~~b~~~b~~~b~~~bbb~~bb~~~~~~~~b~~b~~~b~~~b~b~~~
~~~~~~~b~b~~~b~b~bbb~bb~b~~b~~~~~b~~~~b~~~b~b~~~~~~~b~b~~b~bbb~b~~~~b~~~~~~b~b~b~~~~~~~~~b~~~~b~b~~~~
b~~~~bbb~b~~~bb~~~~~~~~~bbb~b~b~bbb~~~b~~~b~~~b~~~~~b~~~~b~b~b~b~~b~~~~~~~~~b~b~~~~~~~~b~b~~~~~~~~~~b
~bb~~bb~b~b~b~b~~bb~~~~~~~~~~b~~~b~b~~bb~~b~~~~b~b~~~b~~~~~~~~~~~b~~b~~~~~~~bbb~~~~~~~~~b~~~~b~~~b~~~
~b~bb~~~~b~~~b~~~b~~~~b~b~~~~~~~~bb~~~bb~~~~b~~b~bbb~bbb~~~~bb~~~~bb~~~~~b~~~~~~~~~~b~~bb~b~~~b~~~~bb
~~~~~~~~~~~~~~~b~~~~~~~b~~~~b~~b~b~b~~~~~~~~~~~~b~~~~~~b~~~b~bb~~~~bb~~~b~~bb~bbbb~~~~b~~~bb~~~b~b~b~
~b~~b~~~~b~~~~~b~b~~~~bbbb~~~bb~~~~b~~~~~b~~~~~b~~~~~~bb~b~~~~bb~bb~~b~b~~b~bb~~~~~~b~~~~b~b~~~~~~~bb
~~~~bb~~~~bb~b~~~b~~b~~~~bbbb~b~b~bb~b~~~b~~~~b~b~~b~~~~~~b~~b~~~~b~~~b~b~~~~b~~~~~~b~~~~b~~b~~bb~b~~
~~~~~b~~b~b~b~~~~b~~~~~~~~b~b~~b~bbb~~b~~~~~~~b~bb~~bb~~b~~~~~b~~~b~~~~~~~~b~bb~b~~~~b~~~~~~~~b~~~~~~
~b~~~b~~~b~~~~~~~~~~b~~~~~b~~b~~bbb~~b~~~~b~~~~~bb~~~bb~~~~~~~~~~~bbb~~~b~b~~~b~~~bb~~~~~~bb~~~~~b~b~
~bb~~~~~bbbb~~b~~~bb~~~b~~~b~bbbb~b~~~~~b~~~~~~~b~bb~b~b~~b~bb~~bbbb~~~~~~~~~~~bb~~~~b~~~b~~bb~~~b~b~
~b~b~~b~~~b~~b~b~~~~~~~b~~b~~~bb~~b~~~~~~b~~b~b~bbbbb~~b~b~~~~~bb~~~b~~~~~b~~~~~b~~~b~b~bb~b~bb~b~b~~
b~~~~~~~~b~~~~~bb~~bb~~~~~~~~~~~~~~b~~~b~~~~~~~~~~~~~b~b~b~~~~bb~bb~b~~~~~b~~~~~~~b~~~~b~~b~~~~bb~~~b
~~~~~~b~~bb~b~~~~~~~b~b~bb~b~b~~~b~~~bb~b~~~~~b~b~b~~b~b~~b~b~~~b~b~bbb~b~~~bb~~~b~bb~~~~~~~~bb~bb~bb
~~bb~~~~bb~b~~~b~~~~~b~~~~~b~~~~~~b~~~b~~~~~b~~~~~~~b~~~~~~~~~b~~bb~bbb~~~~~b~~~~~~b~~~b~~b~~~~~~~~b~
~~~~~~~~b~~~~~b~~b~~~b~~b~~~~~b~~~~~~~~~~~~~~~b~b~~~~~bb~b~b~b~~~~b~bb~~~~~~bb~~~~~~~bb~~b~~bb~~~~~~b
~~~b~~b~~~b~~~~~~~b~~~~~~~bb~~~bbbbb~~~~b~~~~b~~~~b~bb~~bb~~~~~~~~~~bbb~b~~~~b~~~~~~~~~~~~~b~~~~bb~~b
~~~~~~bb~~~~b~~~~~~~~~~~~b~b~~bb~~~~~~~~~~~~b~b~b~b~b~~b~~~b~~~~~~~~~~bbb~~b~~b~~~~b~b~~~~b~b~b~~~~~~
~b~~b~~~b~bb~~~~b~~~~b~~bb~~~~~b~~~~~~b~~~~b~b~b~~b~~b~~~b~~~~~~b~bb~~~~~~b~~~b~~~~~~b~b~b~~~~~bbbb~b
~~~~~~b~~~~bbbbb~~b~~~~~~~~~~b~~~b~b~~~b~~~~~b~~~~bbbbb~~b~~~~bb~b~b~~~b~~~b~~b~~b~b~~~~~b~~~~~~~~~~~
~~~~~~bb~~b~bb~~~~~~~b~~~~~~b~b~~~b~b~~~bb~~~~~~~bbb~bb~bb~~~~~~b~~~bb~~~bbb~~b~bbb~~~~~b~~~~~~~~~bb~
~b~~~~b~~~b~~~~bb~~~b~~b~b~~~~~~~~~~~~~b~~~~b~~~~~b~~~~~~~~bbb~bb~~~b~~~~~bbbbbb~~~~~~~~~b~~~b~~~b~b~
~bb~~~bb~b~b~b~b~~b~~~~b~~~b~~bb~~~~~~~~bbbb~b~~b~~~~b~~b~bbb~b~~~~~~~~bb~~~~~bb~~~~~~~~~~b~~bb~~~~~~
~~~bbbb~~~~~~~~~b~b~~~~~b~~b~~b~~~b~~~~~~bbbb~~~b~~b~~~b~~bb~~~b~~~~~bb~~~bb~~~~~~b~b~~b~~bbb~~b~~~~b
~~~~~Sb~~~~b~b~~~~b~~~~b~~~b~bbb~~bbb~~~~~~b~b~~~~~~b~b~~b~~~b~~b~~bb~b~b~~~~~b~b~~~bbb~bb~~~~~b~~~b~
~~~~~~~~~bb~~~~bbb~~~~~~~b~bb~~~~b~b~~bbbb~~b~~~~~~~b~~b~~~~~~~~~bb~bb~~~~~~~~~~~bb~b~~~~b~~b~b~~~~~~
~~~b~~~~~~bb~~b~~~~b~~~~~~~~bb~~~~~~~~~bb~~~b~~~~b~~~b~~~b~~~b~~~bb~~~b~~b~~~b~~~b~~b~~b~~b~bbb~~b~~~
bb~b~~~~~~bb~b~~~~~~~~~~bbb~~~~~~~~~b~bbb~bbbb~~~~~~~bb~~~bb~~b~~~~~~~~~~~b~~bbbbb~~b~~bb~bb~b~~bb~~b
~~~~b~bb~~~b~~~~~~b~~~~~~~bb~b~~~~~~~b~b~~b~~~~~~~~~~~~~~~~~~bb~~b~~bb~~~~~~~~~~~~~b~~~~~~~~~~bb~~b~b
~~~~~~~~~~~b~~~~~~~~~b~~b~~~b~~~~~~~~~~~~~~~~~bb~~~~~b~~b~~~~b~~~~~~~~~~~~~~~~~b~~~~~~~bb~~~~~bbb~~b~
bb~~b~~~~~~bb~~~bb~~~bb~~~b~bbb~~bb~~~~b~~~~~~~~~~~~~~~~b~~~~~~~~~b~~~b~~~b~bb~~b~~b~~b~bb~~~~~~~b~b~
