~~bb~~~b~~~~~b~bb~b~~~b~~~~b~b~b~~~~~b~b~~bb~~~bbb~~bb~~~~~~~~~~~~~~~b~~~~b~~bb~~b~b~~~bb~~~~~~~~~~~b
b~~~~bb~bb~~~~~~b~bb~b~~~bb~~bb~~bbbb~b~~~~bbbb~~b~~~~~~~~~bb~~~~bb~bb~~~~~~~~b~~~~~~~~~~~~~~~b~~~~~~
~~b~~~~~~~b~~bb~~~b~~~b~~b~~b~~~bb~~~bb~~~~bb~bbb~bb~b~~b~b~~~bb~~~~bbb~~~~~bb~~~~~~~~~~~~~b~~~~~b~b~
b~~~~~bb~bb~~b~~bbb~b~~b~~b~~bb~~~~~~~b~~~b~~b~~~bb~~~b~~~~~b~~b~~b~~b~~~b~~~~b~~~~~b~~~b~b~~~b~~~~~b
~~~~~~~~~~bb~b~~~~~~b~~~~~~~~b~~~~~~~~b~~~~~~b~bbb~~~~~~~~~b~~~~~~~~~bbb~~~~~~~~b~~~~~~b~~~~~~~~~~~~~
~~b~~~~b~~~~bb~~~~~~~~~~~~b~~~~b~b~~~~bb~~b~~~~~~b~~bbb~~~~b~bb~~~bb~~b~~bb~~~bb~~b~~b~b~~~b~~~b~b~~b
bb~~bb~b~~~bb~~~~~b~~bb~~~~~b~~~~b~~~~~~~bb~~bb~b~bb~~~~~~~~~b~~~~~b~b~~~~~b~~b~~bb~~~~~~~bbbb~~bbb~~
~~~~~~~b~~~~~~~b~bb~b~bbb~~b~b~b~~~~~bb~~bbb~~~~b~~~~~~~~~bb~b~bb~b~~~~~b~~bbb~~~~b~b~b~~~~b~~~bbb~b~
b~~~~b~b~~b~~~~b~~~~b~~~b~~b~~~b~~~~b~b~~~~~~~~~~~b~~bbbb~~~~~b~~b~b~b~b~~~~~~~b~b~b~~b~~b~~~b~~b~bb~
~bbb~~~b~~bb~~~~b~~~~~~~~~~~~~bb~~~b~b~b~~~~b~~~~~~~~~~b~~~~~~b~~b~~~bbb~~~b~~~~b~~~~~~~~b~~~~~~~~b~~
b~~~~~~b~~~b~~b~~b~b~~~~~~~~~~~~~~b~~~~~~~~b~~b~b~b~b~~b~~b~~~b~~~~b~b~~bb~~~~~bbb~~b~~~~~bbbb~~b~b~~
~~~~~~b~b~b~~~~~~~~~~~bb~~b~bb~~~~~~~~b~bb~~b~~~~b~~~~~b~bb~b~~~~bbb~b~b~~~~b~bb~~~b~~~~~b~~bb~b~b~~~
~~~~~~~~bbb~b~~~~~b~~bbb~~b~bb~~~~~~~~~~b~b~~~~~~~~~~~~b~~~~b~~~~~bb~~~b~~~~~~~~~b~~~b~b~~~~b~~~b~~b~
~~~bb~~~bbb~~b~b~~b~~~~~bb~b~~bb~b~~~bbb~b~b~bbb~b~~b~~~b~~b~~~~~~~~~~bb~~~~~b~~~~~~~~~~b~~~~bb~b~b~b
~b~bb~bb~~~~~~~~~~b~bb~b~~~~~b~bb~~~~~~~~~~~b~~~~~~b~b~~b~~bb~~b~bb~~~bbb~~~~~~~b~~bb~~~b~b~~b~~~~bbb
b~b~~~~~b~~~~~b~~~b~~b~bb~~~b~b~~~~~b~~~~~~b~~b~~~~b~~~b~~~~~b~~bb~~b~~bbb~b~~~b~~~~bb~~~b~b~bb~~~~b~
~~bb~~~b~~b~~~~~~~~~~~~~~b~~~~~~~~~b~~~~b~~~b~~~b~bb~~~~~b~bb~~b~~~b~~~b~bb~b~~~bb~~~b~~~~~~~~~~b~~~b
~b~~b~~~~~~~~~~~bb~~b~bb~b~~~~b~~b~b~~~b~~~~~~b~b~b~~~~~~b~~~~bb~bb~b~~~~b~b~~~~b~~~~~bbb~~~~~bb~b~b~
~~~bb~b~~~~~~~~~b~~b~~b~~bb~~~~~~b~b~b~b~~~~~~~~b~~~~~~b~b~b~b~~bbbbb~~~b~b~~~~b~~~b~~~~bb~~~~~~~~b~b
b~~~~b~~b~b~~~b~~~~b~~~~~bb~b~~b~~b~~b~b~~~~~~b~b~b~~~~~~~bbb~~~~bbb~bbb~~b~~bb~~b~~bbb~b~~~~~~~~~b~~
~~b~b~~~~~~b~~b~~~~~b~~~~b~~~~b~~bb~~b~~~~~~~b~~~~~b~bb~~b~~b~~b~~bb~b~~b~b~~~~~~~b~~~b~~~~bb~~~b~bb~
bbbb~b~~~~~~~~~~bbb~~~~b~~~~b~~b~~b~b~~~~~~~~~~b~~bb~b~~~~~~~~~~b~~~~b~~~~b~b~~~~~b~~b~~~~~b~~bbbb~~b
~~~~~b~~bbb~~~~b~~b~~~bb~~~~b~~~~~~~b~~b~~~~~~b~bb~~~~~~~~b~~bb~b~~~~~~b~~b~~~~~~~~~~~~b~~~~~~bbbb~~~
~~~~~~~b~~~~~b~~~~~~~~~~~b~~~~~~b~b~bb~b~~b~b~~~b~~~~~~~b~bb~b~~~~~~~~b~~~b~~b~~b~~~b~b~bb~bbbb~~b~~b
bbbbb~~b~b~~~~b~~b~~b~b~bb~b~~~~~~~~bb~b~~b~b~b~~b~b~~~b~~b~~~~bb~b~~~b~~b~~b~~b~b~b~~~~bb~b~b~bbb~b~
b~~~b~~~~~~~~b~b~~b~~b~~bb~~~b~b~~~b~~b~~~~b~~~~~~~~bb~~~~~b~~bb~b~b~~b~~b~~~~~~~~bbbb~~b~~b~~b~b~~bb
~~~~b~~~~~~~b~b~~~~~~b~~~~~~bb~~~~~~b~~~~~bb~bb~bbb~~~~~~b~~bb~~b~~bb~~bbb~b~~~~~b~~~~~~b~~~~b~~~~~~~
~b~~~~b~bb~~~b~~b~~bb~bb~~bbb~~~~b~b~~~~~~~~bb~~~~bb~~~~b~~b~b~b~~~~~~bb~~~~~bb~~~b~~b~b~bbbb~b~~~~~~
b~~~~~~b~~~~~b~~b~bb~~~~b~~b~b~b~~~~b~~~~bb~~~b~~~~b~b~b~b~b~~b~~~b~~~~b~~~b~b~b~b~~~~~~~~bb~~bb~b~~~
~b~~b~~~bbb~~b~~b~~b~~~~~~~~b~b~~b~~~~~bb~~bb~~~~~~b~b~bb~~~~~b~~~bb~~~~bb~~~~bbb~b~~~~~~~~~~~~~~bb~~
b~~b~~~~~~bbb~~~~b~bb~b~~b~~~~b~~~b~~~~~~b~b~~~~~b~~~~bb~b~~~~bb~~b~bb~~~~~~~~b~b~~~~~~~bb~bbbb~b~b~b
~bb~~~~~~~~bb~~b~~~~~~~~b~~b~b~bb~~~~b~~~b~~~bb~~b~b~b~~~~b~~~~~~~b~~~~~b~~b~~~~b~~~b~~~bb~bb~~~b~~~~
~bb~b~~~~~~~~bb~b~b~~~bb~~~~~b~b~~~~~~~~~b~b~~~bbb~~~b~b~~~~~~~bbb~~b~~~~~~~~~~bbb~~~~~~~~~~~b~~b~~~~
~~b~~b~~~~~~~~~~~~~~b~~b~~~~~b~~bbb~~~~~~~~~~~~~~~b~b~~b~~~~~bb~~~~~b~~~~b~~~~~b~b~~bbbbb~~bb~~b~~~~~
~~b~b~~~~b~~b~~b~~b~~~~~~~~~b~b~~bb~b~~b~b~~b~b~b~bb~~~b~b~~~b~~~bb~~~~~bbb~bb~~b~~~~bb~~bb~~~b~~~~~b
~~~b~b~~~~b~~~~~b~~bb~~~~~~~~~~~~b~~~~b~b~~~~~~bb~b~~~~b~bb~~~~~~~~~~~~~bbb~~~b~~~bb~~~b~b~b~~~b~~~~~
~~~b~~~~b~~~~~b~~~~~~~b~~~bb~~~~~~~~~~b~~b~bb~~~bb~~~~b~b~~b~~b~b~~~~~b~~~~~~~b~~~~~bb~~~~~~~~~~~~bb~
~~b~bb~~~~~~~~~~~~b~b~b~~~bb~~~~~~~~~~~b~~~~~~bb~~~~~b~~~~bb~~b~~~b~~b~~~bbb~~~b~bb~~~~bb~~~~~~b~~~~~
bb~b~~b~~~~~~bb~bbbbbbbbb~~~~~b~bb~~~~~~bb~~~~~~~~~~~~b~b~~~~~b~~~~~~~~~b~~~~~bbb~b~b~~~~~~~~bb~~~~~~
~b~b~~~~~bbb~~~~b~~b~~~~b~~b~b~~~b~bb~~~~~b~~~~~~~b~~~~b~~~~b~~b~b~~~b~~b~~~~~~~~~~bb~b~~~~~~~~b~b~~b
~~~~b~~~b~b~~~b~~~b~~~b~~~~b~~~b~~~~~b~~~~~~~~b~~~~b~bbbbb~~~~~b~~~~~~~bb~~~b~~~b~b~~b~b~~b~bb~b~bbb~
~~~~~~~~~~~b~~~~~b~~~~~~~~b~~bb~~b~~~b~b~bbb~~~b~~~~~~~~~b~~~b~~~~~~~~b~~~bb~~~~~b~bb~b~~~b~~bbb~~~b~
~~~~~~b~~~b~~~~~~~~~~~~~~b~~b~b~bb~b~~~~~~~bb~~~b~~b~~~b~~~bb~bb~~bbb~~~~bbb~~~b~~b~b~~~~bbbb~~~~~~b~
bb~b~~b~~b~~~~~~~~~~~~b~b~b~bb~~~~~~~~~~~~~~~b~~b~~~~~~~~~~~~~~~~~~b~b~~b~~~b~~~~~~~~~b~~b~~~bb~~b~~~
~~~~bbb~b~~~~b~~~~~~bb~b~~~~~b~~b~bb~~bbbb~~~~~~bbb~b~b~~~~b~b~~~~b~b~~~~~b~~~~~b~~bb~~bb~~~~b~b~b~~~
~~b~b~~bb~b~~~~~~~~~~~b~~~~b~~~b~~~b~~~~~~~~~b~~bb~~~~~~bbb~b~~bb~bb~~b~~~~~~~~b~~~bb~~~b~b~~~b~~~~b~
~~~~~~~~b~~bb~~~b~~~~~~~~~b~~~~~~~~~~~~~~b~bbb~b~bb~~~~b~~b~~~b~~~~~~~b~~~~bb~~b~b~~~b~~~~~b~~~~bb~~~
~~~~b~bb~b~~b~~~~b~~b~b~~~b~~bbbbbb~~~~~~b~~~b~b~~b~~b~b~~~~b~~~~~~~bbbb~~~~~~~~b~~~~~bb~~~~b~b~bb~b~
bbbb~~~~bbb~~~~~~b~~~~~~b~~b~~b~~~~~~~~b~~bbb~~~~~b~b~~~~~~~~~b~b~b~b~~b~~bb~~~~~~~~b~~~~b~~~b~~~~~bb
~~~~~~b~b~b~~~~~~~~b~~~bb~~~~b~~~bb~~b~~~bb~b~b~bb~bb~~~b~~~~~~b~b~b~b~~~~~bb~~~~bb~~~~~b~~~b~~~~~b~~
~~~~~~b~~~b~bb~~b~bb~b~b~~~b~~~~b~b~~~~b~~~~~~~b~~~b~~~bbb~~~bbb~~~~~~~bb~~~~~~b~b~~bb~~~b~~~b~b~~~b~
b~~~~bbb~~b~b~~bb~~~~~~~b~~~~bbb~b~~~~~b~b~~~~~~~~~~~bbb~~~~~~~b~b~~b~~~~~~~~~bb~~b~b~~b~~~~~~b~b~~b~
bb~~~~~b~~~bbb~~~~~~~~~~~~~~~b~~b~~~~~bb~~b~bb~b~~b~~~~b~~~~~~b~~~~~~~b~b~~bbbbb~~~~b~~bb~~~~~~~~~~b~
~b~bbbb~~~bb~~b~~~~b~~b~bbb~b~~~b~b~~~~~~~~~b~b~~~b~~~bb~~~b~~b~~~~b~~~~~b~~~bb~~~bbb~bbb~~~b~~~b~b~~
~~~bb~bb~b~~~~~~b~~~bb~~~~~~~bb~~bb~~b~~bb~~~~b~~bb~b~~b~~b~~~b~~~b~b~~b~~~~~b~~~~~b~b~~~bb~b~~~~~~~b
b~~~~~~~~b~b~bb~b~~~~b~~b~~~b~~~b~~~~~b~~~~~~~b~~~~~~~~~~~b~~~~~bb~~~~~~~bb~~~~bb~bb~bbb~b~b~~~~~~~~~
~~~~b~~~bb~~~~~~~b~~b~~~~~~b~b~~~~~~~~~~~~b~~bbb~~~~bb~~~~bb~~b~b~b~~~~b~~~bbbb~~~bb~bb~~~~~~~~~~b~~~
~~~~~~b~~~~b~bb~b~b~~b~~~~~~~~b~~bb~b~~b~~~~~b~~~bbb~~~b~~b~bb~bb~~~bbb~~~~~~b~~~b~~~~b~~~bbbb~bb~bb~
~b~b~~~~b~~~b~~b~~~~bb~~~~~~~b~bb~~~~~~~b~b~bb~~b~~~~~b~~~~bb~b~~~~b~bb~b~b~~~~~bb~~bb~~~~~b~~~~~~~~~
~~b~~~~~~~~~b~~~b~b~~b~bb~~~~~~~~~~~~~b~~~b~~~~b~~~b~~b~~~~~~bb~b~~b~~~~~~~~~b~b~~~~b~~~~~~b~~~bb~~~~
b~b~~~~~~~~~~~~~~b~~~~~~~~~~b~~~~~~~~bbb~~~~~~b~~~b~bb~~~b~~~~~b~~~bb~~~~~~~b~bbb~bb~~~~b~~b~b~b~bb~~
~b~~bbb~b~~~~~~~~~~b~b~~~~~~~~~~b~~bbb~~~~bb~~~~~b~b~~b~~~~~~~b~~b~~~~bb~~~~~~bbb~~b~~~~~b~~b~~~b~b~~
~~~~~~~~~bbb~b~b~b~~b~b~~~b~~~~b~b~b~b~~~~~b~~b~~~~~b~~~~~~~b~b~~b~~~~~~~~~~~~~~~~~b~~~~bb~b~~~b~bbbb
b~~~b~~bb~~b~~~~~~~~~~b~b~~~~~~bb~bbbbb~~~~b~b~~~~~~b~~~b~~~~~~~~~~bbb~~~~~~~~~~~~~~~~~~bb~b~~b~~~~bb
b~~~~b~~~~~~b~~bb~~b~b~~~~~~b~~~~b~~~~~~~~~b~b~b~~~~~bb~~b~~bb~~~~b~~b~b~~~~b~~~bb~~~~~~~b~b~~b~b~bb~
~~~~~~b~bbb~~~~~bb~~bb~~~~b~~~b~b~~~~b~~~~~~~~b~b~~~~~~~bb~~~~~~~b~~~~bbb~~b~bbb~~~~b~~~~~~~~bb~~~b~b
b~~~~~~~~b~~b~b~~b~b~~~~~~~~bb~b~~~b~~~bbb~b~~b~~b~~~~b~b~~bb~~~~~~~~~~~~bb~~~~~~b~~~b~~~~~~~b~bbb~~~
b~bbb~b~~b~bb~~b~~~~~b~~~~~b~b~~~~~bbb~~~~~~~~~~b~~~~b~~~~b~~~~~b~~bb~~~~~b~~~~b~~bbb~~~~~b~bb~~~bbb~
~b~b~~~~b~~~bb~~b~~~~b~~~~~~~b~bb~~~b~b~~b~~~~~bb~~~~~bb~~~~~~b~~~~~~~~~~~b~~bb~~~~b~~~~bb~~~~~~~~~b~
~b~~b~~~b~~b~~~bb~~bbb~bb~~~~bb~~~~~~~~~b~~~~~~b~bb~b~~~bb~~~b~~~~~~bb~b~~~~b~~~~~~~~~~bb~~~~~~~~b~~~
b~~~~b~~b~~~b~~~~~~b~b~~~b~b~~~b~~~~~~~b~~b~~b~~~~~b~~~~b~~bbb~b~~~b~~b~b~b~~~~b~~~~~~~~~~b~~b~~~~b~~
~~b~~~~~bbb~b~~~~~~~b~~~~~~~~~~~~b~~~~~~~~~~~~~~~~~b~~b~~~~b~b~b~~b~~b~~~~~~~b~bbb~b~bbb~bb~~~~~~~~~~
~~b~~~bb~~~~~~~~~~~~~~~b~~~~b~~~~b~~~~bb~~b~~~~b~~~b~~b~~bb~~~~~~b~b~~b~~~~~~~~b~~~b~~b~~~b~bb~~~b~b~
b~b~~~~bb~~~~bbb~~~b~~~b~bb~~b~~~b~G~~b~b~~~bb~~~b~b~~~~bb~~bbb~~~~~~b~~~~~~~b~~b~b~~~bb~~~~~b~~bbb~~
~~~~b~~b~b~~~bb~bb~~b~b~~~b~~~~~~b~~b~b~bb~~~~b~bb~b~~~~bb~~~~~~~~~~~b~~~~~~~~~~b~~bb~~~~b~~~~~~~~b~b
bb~~~~~~~~~~~~~~~~~b~~~~~~b~~~b~~b~~~b~b~~b~bbb~~~b~~~~b~~~~~b~~b~~~b~~~~~~~b~bb~~~~~~~~b~~b~~~b~~~b~
bb~~~bb~~~~~~~~b~~~~~~~~~~~~~~~~bb~~~~~~~~~~b~bbb~~~~~~b~bb~b~~b~b~~~~~~~~bbb~~~bb~b~~bb~~~~~b~~~~b~~
b~~b~~~b~~~~b~~~b~~b~~~~~~bb~b~~~bb~~b~~~~bb~~~~~b~b~b~b~b~~~~~~b~~~~~~~~~~~b~bb~~~~~~~b~b~~~~~b~b~~~
~~~~~~~~~b~b~~~~~~~b~~~~b~~~~~~b~~~~~~~~~~b~b~~b~bb~~~b~~b~~~~~~~~b~bb~~~b~~~bb~b~~~~~b~~~~~~~~b~~~~~
~~~~~~~~~~~~~~b~b~~bbb~~~~bbbb~~~~b~~~~~b~b~~~~~~~~bb~~b~~~~b~~~~bb~~~bb~~~~b~~b~~b~~~~b~~~~~~~b~~~~~
~~b~~b~~bb~bb~~b~~~b~~~bb~~b~~b~~~~~b~~~b~~~~~~bb~b~b~b~b~~~~~~~~~~~b~~~b~~b~~bbb~~~~~b~b~~~~~~b~bb~b
b~~~~~~b~~bbb~~~~~~b~b~~~~~b~b~~~~~~~~~~~~b~~~b~~b~bb~~~~~b~bb~bb~~b~~~~~~~~~b~b~bbb~~~~b~bb~~~bb~b~~
~bb~~~~~~~b~~b~~~bb~~~bb~~b~bb~~~b~~~~~bb~~b~~~b~~~b~b~~~~~~~b~~b~~~~~~~~b~b~bb~~~b~~~~~b~~~~~b~~~~~~
~~~~~~~b~~~b~~~~b~~~~~~~bb~~b~b~~b~b~~~~~bb~~bbbbb~~~~~~bb~~~~~~b~~~b~b~~b~b~~b~~b~bb~b~b~~~~~bbb~~~b
~~~~~bb~~b~~~~b~~b~b~~~~b~b~~~~~~~b~~~bb~b~~~~~~~b~b~~b~~bb~~~~~b~~~~~~b~~~~~~~~~b~~~~~~~bb~~~~~b~b~~
~~~bb~~~~~~~b~b~~~~~~~~bb~~~~~b~~~~~~~bS~~~~~b~~b~~~bbb~~b~~~~~~b~~~~~bb~bb~b~~~~~b~~b~~~~~bbb~~~~~b~
~b~~~~b~~~~b~~b~b~~~~~b~bbbb~~~b~~~b~~b~b~bb~~~b~~~~~~~bb~bb~b~~b~~b~~~~~~~~~bb~~~b~~b~~b~~~~~~~~~~~~
~~~~~bb~~b~~~b~~b~~~~b~~~~~~~~~bbb~~b~~~bb~b~~b~bbb~~~~~b~~~~b~b~~~~~~~bb~bb~~~~~b~~~bbb~b~~b~b~~~~b~
b~~b~~~~bbb~~~~bb~b~~~~~~~~~b~~b~~~b~~~~~b~~~~bb~~bb~~~~~b~~~b~b~~~~~~bb~~~bb~~~b~~b~b~~~~~b~~b~bb~~~
~~~b~~~~~~~~~b~~~~~~~~~bb~~~b~~b~~bb~~~~b~~bb~~~~~~~~b~~~~~~~b~~~~~~~~~~~b~b~~~~~~~b~b~b~~~~~~b~~~b~~
~~~b~~bb~~~bb~~~~~~~~~~b~b~bbb~~~bb~b~~b~~b~~~~~~b~~~b~b~~~~~b~~~b~b~~~~b~~~~~~~~b~~b~~~~~~~b~~~~~~~~
bb~~~b~~~~b~~~bb~~~b~~~~~~~~~~~~b~b~b~~b~~~b~~b~bbb~~~b~~b~bb~~~~bb~~~bbbb~bbb~bbb~bbbb~b~~~~~~~~~~~~
~~~~~b~~~~~~~~~~b~~~~b~bb~~~~b~~~b~b~b~~~bb~bbbbbbb~~b~~b~b~~b~~~~~~~bbb~~b~~~bb~~~b~~~b~bb~~b~~b~bbb
b~~b~~b~bb~~bb~b~~~bb~b~b~bbb~bb~~~b~~b~~~~~~bb~b~~~~b~b~~~b~bb~~~b~b~~b~~b~b~~b~b~~bb~~~~~b~b~b~~b~~
b~b~~~b~~~~~bb~~~~~~~bbbb~~~bbb~~~~~~~bb~~b~~b~~~~~~~~~b~~~b~~~~b~~b~b~~~b~bb~~~~~~~~bb~~~~b~b~~~~~bb
b~b~~~bb~bb~bb~bb~~~~~~~~~~~~~~bbb~~~~~~~b~~~b~bbbb~~~~~~b~~~~~bb~~~~bbb~~~~~~bb~~~b~~bb~bb~~b~~~~~b~
~~~~~bb~~b~b~b~~~~b~b~~~~~~~~bbb~~~~bb~~b~b~~~~b~~b~~~~b~~bb~~~bb~~bb~bb~~~~b~~~~b~~~~~~~b~~~~~~~~b~~
~bbb~b~~~~~b~bb~~~~~~~~~~~bb~~~bb~bb~b~~~~~~b~~~~~b~~b~bb~~~~~~b~b~~~~~~~~~~~~~~~b~b~~~b~~b~b~~~~~~~~
b~~~~~~~b~~~~b~~b~~~~b~~~~~~~b~~bb~~~~~~~~b~bb~~~~~~~b~b~~~~b~b~~~~b~~b~~~~b~~~~~~bb~~~b~~~~~~b~~b~bb
~~~~~~~~~~b~~b~~~~~~b~~~~~~~~~b~~~~~~b~~bb~~b~~~~~~~~b~~~~~b~~~~~~b~~~b~~~~b~b~~~~~~~~b~~~b~~~~~b~~~~
~~b~~~b~bb~~~b~~~~~~~~~~~~~b~bb~~b~~~~bbbbb~~b~~~~bb~~~~~~~b~~~~b~b~b~b~b~~~b~~~~~~b~~b~b~~~~bb~~~~~~
