~~~~~b~bbb~~~~~bb~~b~~~b~~~~bbb~b~b~~~~~~~~~~b~b~~~~~~bb~b~~~~~b~bbb~~b~~~~~~~bbbbb~~b~~b~b~b~~~~~~~b
~~~b~~~b~~bb~~~~b~b~bbb~~b~~~~~b~b~b~~~~~b~~bb~~b~~~~~~~b~~~~b~~b~~~b~~~~b~~~b~~~~~b~~~bb~~~b~~~~~~b~
~~b~bbb~b~~~b~~~bbb~b~b~~bb~~bb~b~~~~~~b~~~~~b~~~b~~~~~~~~~bb~~~~b~b~~b~~~b~~bbb~~~~~~~~~~~~~b~~~bb~~
~~bb~~~~~~~~b~bbb~~~~~b~~~~~~~~~~bb~~bb~b~~b~~~~~~~bb~bbbb~~~b~~b~~~~~b~~~~~~~b~~bbb~~b~~~~~~bb~b~~~b
~~~b~~~~b~~~~b~~~~b~b~b~~~~~~~~~~~~~~~~~bbb~~~b~bb~~b~~~b~~~~~~~~~~~~~~b~~~~~~~b~b~~~b~~~~~~~bb~~b~~~
~~~~b~bb~~bb~~b~~b~~~~~b~b~~~b~~~bbb~~~~~bb~~b~~~~b~~~b~~~bb~b~b~~b~~b~~~bb~~~~~b~b~b~b~~~b~b~~~~~b~~
bb~b~~~~~~~~~~~bb~~b~bb~~~~~b~b~~~~bb~~~~~~~~bb~~~~b~~~~bb~~b~b~~~b~bb~~bb~b~b~b~~b~~~~~b~~~~~~~~~bb~
~~~b~~~b~~~~~~~b~~b~~bb~~b~~b~~~~~~~~b~b~~~~~~~~~b~~~~b~~~b~bbb~b~~~~~~b~bb~b~~~~b~b~~~~~~~b~~~~~bb~b
~~~~bb~b~~~~~b~~b~~b~bbb~~b~~~b~b~~~~bb~~~~b~b~b~~b~b~~~~~~~b~~~~~~bbb~b~~b~bb~b~~~~~~~bbb~~~~~~~b~b~
~~~~~~~~~~~~b~~b~~~~~b~~~~~~b~b~b~~~~b~~~~bb~b~~~~~~~~~~~~b~~~~~~~b~~~b~~bb~~~~~bbb~~~bb~b~~~bbbb~b~~
~~~bbb~b~b~~~~~~~~~~~~~~~~~~~~~b~~~b~~~~~~~b~~b~b~b~~~b~~~~~~~~~~~~~~~~~~~~~b~~~bb~~~bb~~~b~bb~~b~b~~
~~~~~b~~~~~~~~b~~b~~b~~~~b~b~~~~~~~~~~b~~~~~~~~b~b~b~b~b~~b~~b~~bb~~bbb~b~~~bb~~b~~b~~~b~~b~~b~b~bb~b
~bb~~~~~~b~~~~b~~~~~~~~~~~~~~b~~b~~~~b~b~~~~~b~b~~~~b~~~b~~~~~~b~bb~~~~b~~~bbb~~~~~b~b~~bb~~~~~~~~bb~
~~~~~b~~~~bb~~~~~~~b~~~~b~~~bb~~~~b~~bb~~~b~~~b~~b~~b~b~~~~~~~b~~~bbb~~~~~b~~~~~b~~~~~~~~b~b~b~b~~~~~
~~~~~bbb~bb~b~b~~~~~b~b~b~~~~bb~~~~~b~~bbb~bb~~~~~bb~b~b~b~~~~b~~b~~~~~~b~~~~bb~~~b~b~~~~bbb~b~~~~~~~
~~~~bbb~~~~~b~bbb~~~~~~~~~~~~~bb~b~bb~b~~bb~~b~~b~b~bb~~~bb~~bb~~b~~~~~~b~~b~~~~b~b~~~b~b~~~bb~b~~~~~
~~b~~~~bb~~~~~~b~~b~~~~~~b~~~~~~~~bb~~~bb~~~b~~b~b~bb~~~b~~~b~b~~~bb~~~~b~~b~bbb~b~~~~~b~~~b~~bbb~b~~
~b~b~~~~~~~~~~b~b~b~~~~b~b~~~bb~~~~b~b~~~~~~b~bb~~~b~~b~b~~~~b~~~b~~bb~~~b~~~~~bb~~~~~~~~b~b~b~bb~~bb
~~~~~~~~~~~~~~b~~~b~~~~~~~~~~~~bb~bbbb~~~~b~~~~b~b~bb~bb~~b~~~~~~b~~b~bb~~~~b~~~bb~~b~b~~~bbb~~~~bb~~
b~b~b~~~~b~b~~~b~b~~b~b~bb~~~~~~b~~~b~~~~b~~bbb~~~~~~bb~~~~~b~b~bb~b~~~~~~~~bb~~~bb~b~~~~~~~b~~~b~b~~
bbb~~b~~~~~b~b~~bb~~b~~b~~~~b~~~bb~~b~b~bb~~~b~~~~~~bb~~~~~~bb~~~~b~bbb~~~b~~~~~bb~~b~~~b~bb~b~~~b~~b
~~~b~b~bb~~bb~~~~~~~b~b~~~~~~~~b~~bbb~~b~~b~bb~~~b~~b~~~~~b~~~b~~b~~~~~~~~b~~b~~~~~~~~~~~~b~~~b~~~b~~
~~~bb~~~~~~bbb~b~~~~b~b~~~~~~bb~b~~~b~~b~~b~~bb~~~~~~~~~~~~~~b~~~~bb~~~~~~~~~b~~~~~~b~~~~bb~~~~~~~~~~
~bbbb~~~~~~~~~~~~~~~~~~~~~~~bb~~~~~~~~~~~~~~~bb~~b~b~~bbb~~~b~~~~~~~bb~b~~~b~b~~bb~~~~~b~b~~b~~~~~~~~
~b~~~~~~b~b~~~~~b~~~~~~~~~b~~bb~~b~bb~b~~~~~~~b~b~~b~~~~~~~~~~b~~~~~~b~b~~~~~~~bbbbb~~b~b~~~b~~b~~~~~
~~~~~~~~~~~~~~~b~~bb~~b~b~b~~~bb~b~~~b~~~b~~~~~~b~b~b~~~~b~b~~~b~~~~~~~~~~bb~~bbb~b~~~~~~~bb~~bb~b~~~
~~~bb~~~~~~~~~~b~b~b~b~b~~~~~bb~~~~bb~~~~~b~bbb~~~~~~~b~~~~~~~b~~~b~~~~b~~~~~~~~~~~~~b~~~b~~~~~bb~~~~
~~~~b~~~~~~~~~~~b~~~~~~~~~~~~~~b~b~~bb~~~~~b~~~b~~b~~~~~b~~b~~~~b~~~~~~~bb~~b~~~bbbbb~b~~~bbb~~~~~~~~
b~b~~~~~~~~~~~~bb~~bbb~bb~~b~~~bb~b~bb~~~~~~~~~~~b~b~~~~b~b~~~~~bb~~~b~~~bb~~~b~~~~~~bb~b~~~~~b~~~~~~
b~~~~~~~~~~~~b~b~~~b~~~~b~~~~bb~~~~bb~~~~~b~~~~~~~~~~bb~~~~bb~bb~~~~~b~b~~~~b~~b~~~~~~~~b~b~~~~~~b~~b
b~~b~b~~b~~~~~b~b~b~~bb~~b~~~~~~~b~b~~~~~~~~~b~bbb~b~b~~~~~b~~~b~~~b~~~~~~bb~bb~~~~~~~~~b~~~~bbb~~~~~
b~~~b~~~b~~~b~~b~b~~b~~bbb~~~~b~~~bb~~~b~b~b~~~~~~~~~~b~b~~bb~bb~~~~~b~b~~b~~~~b~~~~~~~~b~~b~~~~b~~~~
b~b~~b~~~~b~~~~bb~b~~b~bbb~b~~bb~~~bb~~~~~b~~~~~b~~~bbb~bb~~~bbb~~~~~~b~b~b~~~~~~~bbb~b~b~~~~~b~b~~~~
~~~~~~b~b~b~~~bb~~~~b~~b~~~~~~~~~~~~b~~b~bb~~b~~~~b~b~~b~~b~~~~~~~~~~~~~~b~b~~b~~b~b~~~~~b~~~b~~bb~~~
~b~b~~b~~~b~~~~~b~b~~~~~~~bbb~b~b~b~b~~b~b~~~~~b~~b~~bbb~~b~b~~~~~~b~b~b~~~~bb~b~~~~~b~~bb~~~~~~b~b~b
b~~~~~b~bb~~~~b~~~~~b~~b~~~~~~b~~b~bb~~~~~~b~~~~~~~bb~~~~~~~b~~~b~~bbb~b~~~~bb~~b~~~~b~bb~~~~b~~b~~b~
~b~~~~~~b~bb~bbbbb~b~b~b~~~b~bb~~~~~~~~b~~b~b~~b~~bbb~~~~~b~~~~~bb~b~bb~~b~b~~b~~b~bb~~bbb~~~~~~~~~~~
~~~~~~b~~~bbb~b~b~b~G~~~~~~~~b~~bb~~~~~~~b~~~~~b~b~~~~~~b~b~b~b~~b~~~b~~~~~bbbbb~~~~~~~~~~~b~b~~~b~~b
~b~~~b~~b~~b~~~~~~~b~~b~~~~~b~b~b~~~~~~~~b~~b~~b~~~b~~~b~~~~~~~bb~b~~~b~b~~~bb~~b~~~~b~~~~~~bb~~~bbbb
b~b~~b~b~b~~~~~~b~b~~~~~b~~~~b~~~~~b~~bb~~~b~~~~~~~b~~bb~~~~b~~~b~b~~~b~~bbb~~~bb~~~~~~~~~b~b~~~~~~~b
~~~b~~b~~~b~b~b~~~~b~~~b~~~~~b~~~bb~b~b~~b~b~~b~bbb~b~~b~~bb~~~~~b~~bb~b~b~~b~~~~~~~b~~~~~~~~~~b~bb~~
~b~~bb~b~~b~b~~~~~bb~~~b~~~~~bbb~~b~~~bb~~~~~~bb~b~~~~~b~~~~~~~~b~b~b~~b~~~~~~~~b~b~~~~bb~bb~~~~~~~~~
~~b~b~b~b~~~bbbbb~~~~b~~bb~~~~~bb~~b~~~b~~b~~~~~b~bb~bb~~~~bbb~~~b~~b~~~~~bb~~~~b~~b~~~~~b~b~b~~~b~~b
~b~~~~b~~b~~bb~~~~~~b~~~b~~b~~~bb~bb~~~~b~~b~~~~~bb~~~bbb~b~b~~~b~~~bbb~b~b~~b~~bb~~~~~~~~~b~b~~~~~~~
~~~b~bb~bb~~~~~~b~b~b~b~bb~~b~~~~b~~~~~~b~~~b~~~~~~~~b~b~~bb~~~b~bbb~b~~bb~~~~~~~~~~~~~~~~~~~~~~~b~bb
b~~~~~b~~~~~~~~~b~~~~~~b~bbb~~b~~b~~~~~~b~bb~~~~~~~b~b~~~bb~~~~~~~~~~~~~b~~b~~~~~~bbb~~~~~~~~bb~~b~~~
b~~b~b~~~~b~~~~b~b~~~~~~~~~b~b~~~b~~~b~~~~b~~~b~~~b~~~~b~~~~~~b~~~bbb~~b~b~~~~~~b~~b~b~~~~~~~~b~~~~b~
b~~~bb~~~~bbb~b~~~~b~~~~b~~~~~~~~b~~~~~b~~~~~~~b~b~~b~b~~~~~b~~b~b~bb~~b~~b~~b~b~~b~~bb~~~b~~bbb~~~~b
~b~bbbb~~b~~~b~~~b~b~~b~~~b~b~~~~b~~b~b~~~~~~~~b~~~b~~~~bbb~~~bb~~~bb~~~~~~~~~~b~~~~b~~b~bb~~~bb~~b~b
~~bb~~~~b~~b~~~~~~b~~~~b~~~~~~b~~b~~~~~~b~~~~~~~~~~~~~~~~b~bb~~b~~~~~~~bb~~b~b~bbb~bb~b~~~~~~~~~b~b~~
~~~b~bbb~~~~~~~~~b~~~~~~b~~~~~~~~~bbb~~~b~b~~~~~~~~~~~b~b~b~~~b~~bbb~~~~~~~~bbb~~b~~~~~~~bb~~~~~~~~~b
b~b~~~~~~~~~bbbb~~~~b~~~b~~~~~bb~b~~bbb~~~~bb~~~b~~~b~~bb~~~~~~b~~~~~b~~~~~~bbb~~~b~b~bb~~~~bb~~~b~~~
~~~~bb~~~b~~~~b~~bbbb~b~b~b~~~~b~~~~~~~bb~bb~~b~~~~~~b~~~bb~~~~~~~~b~b~bb~~~~~~~~b~~~bb~~b~~b~b~~~~~~
~~~~~~~~~bb~~~b~b~b~~~b~~~~~~~b~~b~~~~b~~~~~~b~~b~bb~~b~~~~b~~~~~bb~b~~~~~b~~~bb~~~b~b~~~b~~~b~~~~~~b
~~~~b~~~~~~~~~bb~bbb~b~~~~~b~~bb~b~bb~b~b~~~~~~~~~~~~b~b~~bb~~~b~~b~~~~~bbb~~~b~b~~~b~b~~~~~~~~~~~~b~
b~~~~b~~~~~~~~~~b~~~bbb~~~~~~~~~~~~~~~b~~~~~~b~~b~b~~~~~~~~b~~~~~~~~~~~~~~~~~~~~~b~~~b~~~~~~~b~~~b~b~
~bbb~~~~~b~b~~b~b~~~~b~~~~b~~~~b~b~~~b~~b~~~~~b~~~~~~bb~bb~~~~~~~~~~b~~~b~~~~~~~~~bb~~~~b~~~b~~~~~b~~
~b~~~bb~~b~~~bbb~b~b~~~~b~b~~~~~bb~b~~~~~~~b~b~~~~~~b~b~~~~~~~~~~b~b~~~~~b~~~~~~b~~~~bbb~~b~~b~~~b~~~
~b~~~b~b~~~~~~~~~b~~bb~~~b~~~~~~~~~bb~~~~~~b~~b~~b~~~~bb~~~~~~~bbb~b~~~bb~~~b~~~~bb~bb~~~b~bb~bb~b~~~
~~~bb~~b~~~bb~~b~~~~bb~b~b~~~b~~b~b~~b~~~~~~~~~~b~b~bb~~~b~~~~~bb~~~b~~bb~bb~bb~~~~~~~~b~~b~bb~~~bb~~
~~~b~~~~~~~~b~b~b~~~~~~~b~bb~~~~~~~b~~b~b~~b~~~~b~b~~~~~b~~~b~~bb~~~~~~~~~b~bb~~~~~~~b~bb~bb~~b~~bb~~
~~~~~b~bb~~b~~~b~~~~~~b~~b~~b~~~bbb~b~~~~b~~~~~b~~~~bb~~~~~~~~bb~~b~~~b~bb~bb~~bb~~b~~b~b~~~~bb~~b~b~
~~~~~b~b~b~~~b~bb~bbb~~~~~~~~~~~b~bbb~b~~b~~~~~~bb~~~b~~b~~b~~~~~bbb~b~b~b~~~~~~~b~b~b~~b~~b~~b~~~~~~
b~b~~b~~bb~b~~b~~~~b~~b~~bb~~b~~~~~b~b~~~b~b~~bb~~b~~~~~~b~~~~~~~~b~~b~~~b~~~~~b~~b~~~bb~b~~~b~~~~b~b
~b~~b~~~bb~b~~~~~~~~b~b~~b~~~b~~b~b~~~b~~~~~~~~~~b~~~~~~~~b~~~b~~~~bbbbb~~~bb~b~~~b~~~b~~~~~~~~~~b~~~
bbb~bb~~~~~~~~b~~~~~~~~~b~~~~b~~~~~b~~~~b~~~~~~~~b~bb~~b~~~~~~~~~b~b~~~~~b~~b~~b~~~~~~~~b~~b~~b~b~~~~
b~~b~~~b~~~~~~~~b~~~~~b~bb~b~~~~bb~~~~~b~b~~b~~b~bb~b~~~b~~bb~~~~~~~~~~~~~b~~~b~~bb~~~~~~~~b~bb~~~~~~
b~~bb~~~~bb~~~~~~b~~~~~~bbb~~bbb~~~~b~~~~~b~~b~~bb~~b~~~~~b~~~~b~~~~b~~~~b~~~~~~b~~~~~~~~bb~~~~~b~~~~
~bb~bb~b~~~~~b~~~~~~~~~b~b~~b~bb~~~~~b~~~~b~b~~~~b~~~bb~~~b~~bb~~b~~~~b~~~b~~~~b~b~~~~b~~~~~~~~~~b~~~
b~b~~~~~~bbb~~b~b~~~bb~~~~b~~~~~b~~b~b~~~~~~b~~~~~b~~bb~~~~~b~~~~~b~~~b~~~b~~bb~~~~~~~~~~~~~bb~~~~~~~
~b~~~bb~bb~~~bbbb~~~~~~~~~bb~~bb~~b~b~~~~~~~b~~~bb~~~b~bb~b~~~~~~b~~~~~b~~~~~~~b~b~~~~~~~~~~~~~~bb~b~
~bb~~~~~~~b~~~~~~~~b~~~b~~b~~~bbb~~~b~~~~b~b~~~bbbb~b~~~~bbb~b~bbb~b~b~~bb~~~~~b~~~~b~~~~~b~~~b~b~~~~
~b~~~~~~~~b~~~~~~~~~~~~~b~bb~b~~~~~~bb~~~~~~~~~~b~~~b~b~~~~~b~~bS~~~~~b~~~~bb~~b~~~~~bb~~~~~b~~~b~~~~
~~~~~b~~bbb~b~~~~~~~~bbb~~b~~b~~b~~b~~~~~~~~b~~~~~b~~~~~~~~~~b~bb~b~~~~b~~~~~~b~b~b~bb~bb~~~~bbb~~~~b
~~bb~bb~~b~~~~~~b~~b~b~~bb~~b~~~b~bbbb~~~b~~~bb~~bb~b~~~b~~~~~~~~~~~~~b~~b~~~~b~~bb~~b~~~bb~bb~~~b~~~
~~~~bb~~bb~~b~~~~b~~~bb~~~~~~bb~~~b~~~~~~~~~~~bb~b~~~b~~b~~~~~b~~~~bbbb~~~b~~~b~~b~~~~b~~b~~~~~~bb~b~
~~~~~b~~~~b~~~~b~~b~~b~~~b~~~bb~~~~~~bb~~~~~~~~b~~b~~~~~~b~~~~~~~~~b~~~~b~~~b~~~~~~bbb~bb~~~b~~~~b~~~
~~~~b~~~~~b~~~b~b~b~~b~~b~~~~~~~~~bb~bb~b~~~~~b~~b~~~bbb~~~~~~~~b~bb~~~~bb~~b~b~~~b~~~~~~~~~bb~~~~~bb
~~~~~~~~~~~b~~~~~~~b~~~b~b~~~~~~~~~b~~b~~~~~~~~~bb~b~~~~~~~~~b~~~bb~~~~~~bbb~b~b~~~~~bb~~b~~~b~~~~bbb
~~~~~b~~~bb~~b~~~b~b~bbbb~~~~~~b~~~~~~~~b~~~~~~~bbb~~~~~~b~~~~~~~~~~~~~~~~~~b~~~~b~~~~~~~~b~~~~~~b~~b
b~~~b~~~~~~bbb~b~b~~~~b~~b~b~~~bb~bbbbb~bb~~bb~~~~bb~bb~b~~b~b~~~bb~b~~~~~~bb~~~~b~~~~~~~bb~~bbb~~~~~
~~~~~bb~b~~~~~~~~~bb~~~~b~~b~~~~b~~~~b~~~b~~~~b~~b~~~b~bb~~bb~~~bb~~~~~~~~bb~b~~bb~~bb~bbb~~~~~~bb~b~
~~~~~~~~~~~~bb~~~~b~~bbb~~b~~~b~bbb~~~~b~~b~~bbb~~bbbb~b~~b~~~~~b~~b~b~bb~~~bb~~~~bbbb~bb~~b~b~b~~~~~
b~~bbb~b~~~~~~~~~~~~b~~b~~~b~~~~~~~~~~~~~~~~~bb~~~~b~b~~~b~~~~bbbb~~~b~~~~~~~~~~~~~~bb~~~b~~b~~~b~~~~
~~b~bb~~b~~~~b~b~~~b~~b~~~~b~~bbbb~~b~~~~~~~~~~~~~bb~bbbb~bb~~~~bbb~~~~~b~bb~b~~bbb~~~~~~~~~~~~bbb~~b
~~bbbbb~b~b~~~b~~~b~~~b~~~~~~~b~bb~~~b~~b~~bb~~~b~~b~b~~~~~b~b~~bb~~~~~~b~b~~b~~~~~b~b~b~~~~~~~~b~~~b
b~~b~~~~~bb~~~~~~~b~~b~~~b~~b~~~~~~~b~~~~~~b~bb~b~b~~~~~~~~~b~~~~~b~~bb~~~~~b~~~~~~~~~b~~~b~~~bbb~~~~
~~~~~~b~~b~~b~~~~~~~bbbbb~~bb~~b~~b~b~~b~~b~~bb~b~~~b~~b~bbbb~~~~b~bb~bb~b~~~~~b~~b~~~~b~~~~b~~~~b~~~
~~b~b~~~bb~~~~~~~b~~~~~~~~~~bb~~~~~~~~~bb~~~~~~~~~~~~bb~b~~~~~~~bb~~b~~~~~~~~~~~b~~b~bb~~~~~b~b~b~~~~
b~~bb~~~~~~~b~~~~~bbb~~~~~~~~~~bb~~~~~bbb~~~b~b~~b~~~~b~b~~b~~~bb~b~~~bb~bb~~~~bbb~bbb~~~b~bbb~~~~~~b
~~~b~~~b~~~~b~b~bb~bb~~~~bbb~~b~b~bb~b~bb~~~~b~~b~~~~~~bbb~b~b~~~b~~~b~~b~~~~~b~b~~~~~~~~~~~~~~~~b~~~
~b~~~~b~~~~~~b~~b~~~bbb~~~~b~~~~~~~b~~b~b~b~b~~~b~~~b~~b~b~~~~~b~~~~~~~~~~~~b~~~bb~~~~bb~~~~~~bb~~~~~
~b~bbbb~~~~~b~~~~b~b~b~~~~~bbb~~~~bb~~bb~~~~~~~bb~~~~~~bb~b~~~b~b~~b~b~~b~bb~~~~~~~b~~~b~~~b~~~~~b~~~
~~~~~~~~b~~~~~~~~~~b~~b~b~~~b~~~~~~bbbb~b~~~~~~~b~~~~~~b~b~~~~~b~b~~~~~~~bb~bb~~~~~b~~~~b~b~~b~b~b~~~
~b~~b~~~~~~b~~~~~~b~~~b~~bbb~~bb~~b~b~b~bb~~~~b~~~b~b~b~b~~~~~b~~~~~~b~~b~b~~~bb~b~~~~bbb~~bb~~bb~~~~
~b~~b~~~~~~b~b~bbb~~~~~~~~~b~~~~~~~~~b~~~~~b~bb~~b~~~b~~~b~~~b~~b~~b~~~b~~b~~~b~~~~~b~~~b~b~~~~b~~~~~
b~~~~b~~b~~~~~~~b~bb~bb~b~~~~~~bb~~~b~~b~~~b~~b~~~~b~b~~b~~~~~~~~b~~b~bbb~~~~b~bbb~~~~bb~~b~~~~~~b~~~
bb~~~b~b~~~b~bbb~~~b~~~~~b~~~~b~b~~~~~b~b~~~b~b~~~~b~b~b~~~~bbb~~~b~~~~~~~~~b~~b~b~b~~b~~bb~~~~bb~~~~
~~~~~b~~bb~b~~~~~~~~bbb~bb~bb~bb~b~~~~bb~b~~b~~~~b~~~~~~b~~~~~b~~bb~b~~~~b~~~b~~b~~~~~b~~~~b~~~bb~~~~
bbb~~~bb~~b~b~~~~~~~~b~b~~~~~~~b~~b~~~~~b~b~b~bbb~~~~~~~~~~~~~~bb~~b~~b~~b~~~b~~~bb~~~~~~~~~~b~bb~~~~
~bb~~~~~~~b~~~b~~~~~~~~~~~~~bb~~b~~~~~~~b~bbbbb~b~~~~~~b~~~b~b~~~~~~~~b~~b~b~bb~~~~~~~~~~b~bb~bbb~b~~
