~b~bb~~~~bbb~~b~~~bb~~~~~b~~~~bb~b~~~b~bb~~~~b~bbbb~~b~~bbb~~~b~b~bb~~~~~~bb~~~b~~~~~~~~~bb~~~b~~~~~~
~~b~~~bb~b~b~b~bb~b~b~b~bb~~~b~b~b~~b~~b~~~~~bb~~~~~~~~b~b~~~b~~~~~~~~~b~~~~~b~~~~b~~~b~b~~~~~~~~~bb~
~b~~b~~bb~b~~b~~~~b~~~b~~~~~~~~bbb~~~~bb~~~~bbb~~~~~~~b~b~~~~bbbbb~~~~~bbbb~~~b~~~~~~b~bbb~~b~b~~~bb~
~bb~~b~~~~~b~b~~bb~~b~~b~~~~~~b~~~~~~~b~~~~b~~b~~bb~~b~b~~~~b~~~~b~~~~b~~~~~~~bb~~b~~~~~~bbbb~b~bb~~b
~b~~~~~~~b~~~~~b~~~~b~bb~~b~~~~~~~~~~~~~~~~bbb~~~b~~~~bb~~~~b~b~~bb~b~~b~~~b~~~~~b~b~~~~~~~~~b~~~~~~~
~~~bbbbb~~~~~~b~~~~b~~~~~b~~bb~bb~~b~~b~~~~~b~b~~b~~~b~~bb~~~~~~b~b~~~~~~b~b~b~~~~~~~~~~bb~~~~~~~~~b~
bb~~~~~~b~b~~~~~b~~~b~~~bb~b~b~~~~~~~~~bb~~~~~~~~~b~bbbbbb~~~~~b~~~~~~~~~~~bbb~~~~b~~b~b~~~bb~~~~~~b~
~b~~~~~bb~b~b~b~~~~b~b~~~~b~~~~b~~~~b~bbbbb~~bb~~~~b~~b~~~~~~bb~b~~~~~b~~~~~~~~bbb~~b~~b~~~b~~~bb~~~~
b~b~~~~~~b~bb~~~~~~~~b~~b~~~~~b~~~~~~~bbbb~~~~~~~~~b~~~~b~b~~b~~b~bb~~~bb~~~~bb~~~b~~b~b~~~~bbbb~~~~~
~b~~~bb~b~~bb~b~~~~~~~b~~~b~~~~~~~~b~~~~~~~~b~b~~~~~~b~~~~~bb~~~~~~~~b~b~b~bb~~~~~b~~~~~b~~bb~~~b~b~b
~~~~~~~~~b~b~bb~b~~~~b~bbb~~b~~~~~~~~~~~~~~~~~b~b~~bb~~bb~~~bb~~~b~b~b~~b~~~bb~~~~~~~b~bb~~~~~b~b~b~~
~~~b~~~~b~b~~b~~bb~b~~~b~b~~~b~~~bb~~b~~~~~b~~~~~~bb~~~~~~~b~b~~~~~b~~~~~b~~~~~~b~bb~~~~~~~~~~~~b~~~~
~~~~~~b~~~b~~~b~~b~~~~b~~~b~~b~b~~~~~~~~~b~b~b~b~~~b~~~~~~~~b~~~~b~~~b~~~b~~~b~b~~~~~~~~~~b~~~~~b~~~b
bb~~~~~bbbbb~~~~bbbbbbb~bbbb~bb~bb~~b~~~~~~b~~~~b~b~b~~~~~b~~~bb~b~b~~b~~~~b~~~~bb~bb~~bb~~~~b~~~~~b~
~b~~~b~~~~~~bb~~b~~bb~~~~~b~b~~~~~~b~~~~b~~b~~~b~~~~~~~bb~~~b~~b~~bbbb~b~~~~~~~~~b~~b~~~~b~b~~~~~~~bb
~~~~~~b~bb~b~~b~~~~~~~~~~~~b~~~b~b~~~~~b~bb~~~~~b~~~~~bbb~~~~~b~~~~~~bbb~~~~~b~~b~~~b~~~~~~~~~~~bb~~~
~b~bb~b~~b~b~~b~b~~~~~~~~~bb~~~b~~b~~~~~b~~b~~b~b~b~~~b~~b~~bb~~b~~~~~b~b~~b~~~~~b~~~~b~b~~~bbb~b~~b~
~~b~~b~b~~bb~b~~~~~b~b~~b~~~~~~~~~b~~~~~~~b~b~~b~bb~~~~~~~~~~~~bb~~~bb~~~~~~~~b~bb~~~~~b~~~~~b~~~b~~~
~~b~~~b~~b~bbb~~~~~bb~~~bb~~~~b~~b~~~~~b~~b~~~~b~~~~~bb~~~~~b~~~~~~~~b~~~~b~~b~~b~bb~~~~b~~~~~~bbbb~~
~~~~~~b~~bbb~~~~~~~~~bb~b~~bb~~~b~~~b~~~b~~b~bb~~bb~bb~~~~~~b~b~~~bb~~bb~b~bb~~~b~b~b~~~~~b~~~b~~b~~~
~~~~bb~~~b~~~~~~~b~bb~~~bb~~~~~b~~~~bb~b~~~b~b~b~b~~~~b~b~~~~~~~bb~~b~b~bb~b~~~~~b~~b~~b~b~~~~b~~~~~~
~b~~bb~~b~~~~~~~bb~~~~~~~~~~~b~b~~bb~~b~~~b~~~b~~~b~~~bb~~~b~bb~~~~b~~~~bbb~b~~~~~~bb~~~~~~b~~~~~~b~~
b~b~~~~b~~~bb~~~b~~~~b~b~bb~~~bbb~bb~~~~bb~bb~~b~b~b~~bb~~~~~b~b~~~bb~~~~b~~~~bbb~~~~b~~bb~bb~b~~~~~b
~~~~~bb~b~bbb~b~~~~~bbb~~~b~bb~~~~~bb~~b~b~~~~~~~~~~bb~b~~b~~b~bb~b~~~~b~~~~~~~~b~~~~~~~bb~~~~~~~~~~b
~~~~~~b~b~~~b~~~~b~bb~b~~~~~~~~~b~b~~~b~b~~~~~~b~~~~~~~~~~~~~~b~~~b~~~~~~~~~b~~~~~~b~~~~~~~~~~~~~b~~b
b~~b~~~~~~~b~~~~~bb~~~~~~b~bb~b~bb~~b~~b~~b~~~~~b~~~~~~~b~~b~b~~~~b~~~bb~~bbbb~b~~b~bb~~b~~~~~b~~~~~b
~b~~b~bb~~bb~~~~bb~~~~~~~~~~~~b~~~bb~~~~b~~~~~b~~~b~~~~~b~~~~b~~~b~bb~~b~bb~b~~~~~~~b~b~~b~b~~~bb~bb~
~~~~~b~~b~~~~~b~b~~~~~~~b~~~~bbbb~bb~~~~~~b~b~b~bb~~~~~~~~b~bb~b~~~~~~~~b~b~~b~b~~~~~b~~~~~b~~bbb~~b~
b~~bbb~b~~bbb~b~b~~~~~~~~~~~~~~b~~b~~~~b~~~~b~~bb~~~b~~~~~b~~~~~~~~~b~b~~bb~~~~~~~~~~~b~b~~b~b~~b~~~~
~~bb~~~~bb~b~~~~~~bb~~~~bb~~~~b~~~~~~b~~b~~~~~~~~~bb~~~~~~~~b~b~bb~~~~~b~b~~~bbb~b~~~~~~bb~b~b~b~~b~~
bb~b~~bb~~~b~bb~bb~~~b~~~~bb~b~~~b~~~b~b~b~bb~~~~b~~~~~~~~~~~~bb~~~b~~~~b~~~~b~~b~b~~b~b~~~~b~~~~~b~~
~~~~bbb~b~~~~~~~~~~b~~~~~~~~bbb~~b~b~~b~~~bb~~b~~bbb~~~~~~b~~b~~~~~b~b~b~bb~~b~~~~bb~~bb~b~~~~b~~~~~b
bb~~~~~b~~~~~~~b~bbb~~~bb~~~~~~b~b~~~~~~~~~~~b~~~b~~b~b~~~b~~~b~~~~~~~~~~~~~~~b~~~b~~~~b~~~~~~~~~~~~~
~bbbb~~~~~~~~b~b~~~~~~b~~~b~b~~~~~bbbb~bb~~b~~~~~~~b~~bb~~b~~~~~~~~~~b~~~bb~~~~~b~b~~~~~~b~~~bb~b~~~~
~b~~~b~b~~~~~~~~~b~~b~~~~~~bb~b~b~~~b~~b~bb~~~~~~b~~~b~~b~~b~~b~b~~~~bbb~b~b~~~~~~~~bb~~~b~~~b~~bb~~~
b~~~b~~~~~~~bb~~~b~b~~~~bb~~~~~~~b~b~b~~~b~~~b~~b~~b~~b~b~b~b~bbbb~~b~~~~b~b~~~~~~~~~~bb~b~b~~~~b~b~~
b~b~~b~~~b~~b~b~bb~~~~bb~~~~~~~~b~~~~~~~~b~~~~b~~~~~~~~~~~b~b~~~b~b~~b~~b~b~~~bbb~~~b~~~b~b~bbbb~~~~~
~~~~~b~b~~~bb~b~b~~~~~~~~~b~~~~~b~~~~~~~bb~~b~~~~~~~~~~~~bb~b~~~~b~b~~~~~~~b~~~bb~bb~~b~bb~~~~~bbbb~~
~~~~~~b~b~~bbbb~~~~~~b~~b~b~~b~~~~~~~bb~~~b~~~~~~~b~~bb~~~~~~b~b~~~~~b~~~~~~b~~~~~~bb~~~b~~~~~~~b~~bb
~~~~~~~~b~~b~~b~~~~~~b~~~~b~b~~~~~~~~~~~~~~~b~~~~~~~~~~~b~~~~b~~~~b~b~~~~~~~bbb~~~~b~~~~bbb~~b~b~~~~b
b~~b~b~~~~~b~~~b~~~~b~b~~~~~~~~~~~bb~~~~~b~~~~b~~~~~~~~~~~~~~~~~~~b~~~bb~~b~bbbb~~~~bb~~~~~b~b~~b~~~~
~b~~~~~b~~~~bb~b~bb~~~~bbb~~~~b~~~~~~b~~bbbb~b~~b~~bb~~b~~~bb~bb~bb~b~~b~~~~b~~b~~~b~~~~~~b~~~bb~b~~~
bb~~~~~~b~~~~~b~~~~~b~~~~~b~~~~~bb~~~~~~b~b~~~bb~~~~~~~~~bb~~~~bb~~~~~~~~bb~~~~~~b~~~~~~b~~~~~b~~~b~~
~~~~b~~~~bb~~~~~b~b~~~~b~~b~~b~~bb~bb~~~b~~~b~~b~~~~~~bb~~~b~~b~~~~~bb~~~~~b~~~~~b~~~b~b~bb~~~~~~b~b~
bb~~~~~~bb~~~~~~~~~~~~~~~~~~b~~b~~~~~~~~b~b~~~~b~~b~~~~~~bbbb~b~~bb~~bb~bbbbb~~~~~~~~~~~~b~b~bb~bb~~b
~~~~b~~~~~b~~~~b~bbb~~~~~~~~~~b~~~~~~~~~~~~~~~b~~~b~bb~~~~b~~~~~~~b~~b~~~~~~~b~~~~~~~~~~~b~~~b~~~~~~b
bb~~~b~~b~~~~~b~~b~~~b~~~~b~b~~b~~b~~~~~~~bb~~~~~b~~~bb~~~~~~~~b~b~~~~~~~~~~~b~b~~b~~~b~~~~b~bb~~~~~b
~b~~~~~~~~b~b~~~~b~~~bbb~~b~~b~b~~~~~~b~bbb~~~~b~~~b~~~~~~b~~~~b~b~~~~b~b~bb~~~~b~~~~~~b~~~~~b~~~~~~~
b~b~~bb~~b~bb~~~~~b~~~~~b~~~~~~~~~b~~~~b~~~b~~b~~~~b~~~b~~~b~~b~b~~~~b~~bb~bb~~~~~b~~~~~~~~~~~bbbbb~~
b~~~~~b~~~~~~~~b~~bb~~bb~~~b~~~~~b~b~b~~b~~~~~~~bbb~b~bb~~~b~b~~b~~~~bb~b~~~b~bb~~~bb~~b~~~~bb~~~~~~~
bb~~~b~~~~~~~bb~b~~~~~~~~~~bb~~bb~bb~~bb~~~~b~b~bb~~~b~~bb~b~~~~b~bbb~~~bb~~b~b~~~b~~b~~~~bb~bb~~b~~b
~~b~b~b~~b~bbbbbb~bb~~~~~bb~~b~~b~~~~~~~~b~~~bb~~~b~~~b~~~~~~b~bb~~b~~~b~bb~b~~~~~~b~~~b~~~~~~~~~~~~~
~b~b~~~~~b~~b~bb~~~b~b~~~~b~~~b~~b~b~~~bb~b~~~~~b~b~~~~bbb~~~~~~~~~b~~b~~bb~b~~~b~b~~~~b~~~~~~b~b~~b~
~~~b~b~~~~~~~bb~~bb~~b~~~bb~~~~~~~b~~~b~b~~~~b~~~~~b~~~~bb~bb~b~~~~~~b~~bb~~b~~~~~~~~~bb~~~b~~~bb~~~b
~b~b~bb~~b~~~b~~~~~~~~~~~bb~~~~~b~~~~~~b~b~b~~~~b~~b~b~~~~~~~~~~~b~~~~~bb~b~~~~bb~b~~~~b~bb~~~~~~bbb~
~b~~b~~~b~~~~~~~~~bbb~~b~~b~~~~~~b~~b~~~bb~b~~~b~~~b~bb~~b~~~~~~~~~~~~~~~~~~bb~bbb~b~~b~b~~~~~~~bb~~~
bb~~~~~~~~~~~~~~b~bb~~~b~~b~b~~~~~b~~~~bb~~~~~~~~bb~~~bb~~b~~~bb~b~~b~b~~~~~~~b~b~~b~b~~~b~~~b~b~b~~~
~~~~~~bb~bb~~bb~b~~~b~bb~~bbbb~b~~~~~~~~~~~~~~b~bbb~~b~~~~bb~b~~~~~~b~~~b~b~b~~~~~~~~~~b~b~~b~b~~b~~~
~b~~~~~b~b~~b~bbb~b~~~~b~~~b~~~bb~bb~~~~~~~~~~~b~~~bbb~~~~b~~~~bb~~~bb~~~~~~~~~b~~~bb~bbb~~b~b~b~~b~b
~~~~~~~~~b~~~~b~~~b~bb~b~bb~b~bb~~~~~~bb~~~~~~~~~~~b~~~~~b~~b~~~~~b~~~~~~~~~~b~~~~~~~bbb~~~~~b~b~b~bb
~~bb~~~~~bb~~~~~~b~~~~b~~bb~b~b~~~b~bb~~~~~b~~~~~~~~~b~~~~~~~~~~~~b~~b~~~bbb~~~~~~~~~b~~~bb~b~~~~b~bb
b~G~b~bb~b~bb~~~~~~~~~bb~~~bb~b~~~~bb~~~~~b~~~~b~b~~bb~~~~b~~~~bb~b~b~bb~~~b~~~~~bb~~~~~b~b~b~bb~b~b~
~~~~~~~~~bb~~b~~~~~~~~~~~bb~~~b~bb~b~b~~bbb~~b~~~~~~b~~~b~~~~~~b~~bbbb~~~~~b~~~~~~~~~b~~~~~~b~~~~b~~~
b~~~~~~~~~~~~bbb~~bb~~~~b~~bb~~~b~b~b~~b~~~b~~~~~~~~~b~~~b~b~~b~bb~b~b~b~~~~~~~b~~b~~~~~~~~~~~~~b~~~~
bb~b~~~~~~b~~~~b~~~~b~b~~bb~~b~b~b~~~~~~b~~~~bb~~~~~~~~~~~~~b~~b~~~~~b~~~b~~~b~~~~~~~bbb~~~bbbb~~bbb~
~b~~~~~~~~~b~~~~~~bb~~b~~~~~bb~b~~~~b~~~~~bbb~~~~~~~b~b~b~~~~~~~~~~~~~b~b~bb~~~~~~~b~~~~~~~~~~~b~bbbb
~b~b~~b~~~~b~~b~~~~~~b~~~bb~bb~~~~bb~~~~~b~bb~~~~b~bb~~~~b~~b~b~~~~b~b~~~b~b~~~b~b~~b~~~bb~~~~~~~~~~b
~~~b~~b~b~b~b~b~b~~b~~bb~b~~~~b~b~~bb~b~bb~b~~~bb~b~b~b~bbb~~~~~b~~~b~~b~bb~~~~bb~~~~~~~b~~~~~~b~~~~~
~~~~~~~~~~b~~~~~~~~~b~b~b~b~~b~b~b~bbb~~~b~b~~~~b~~~~~~~~~~~~~b~b~~~~~bb~~~~~~b~~~~~~~b~b~~~~~~~b~b~~
~~~~~~b~~~b~~~~b~~~~~b~~b~~~~b~b~~~~~~~b~~~~~~b~~b~~~~b~~bb~~b~~~~~~b~~~~bb~~bb~~b~~bb~b~b~~~bb~~bb~~
bb~bb~~~~~~~~b~~~~bbb~b~b~~~b~b~~bb~~~~~~~~~bbb~~bbb~~~~~~~~~b~~~~~~~b~~~~b~~~~~~~b~b~~bbb~b~b~~~b~b~
b~~~~~~~~~b~~~~~~b~~~~~~~~b~b~~~~~b~~~~~bbb~~b~~~bbbb~~~b~~b~~bb~~~~~~~~~~b~~~b~~~~bb~bb~~~~~~~~b~~~~
~bb~~~b~~~~b~b~~b~b~~~b~b~~~b~~~~b~bb~~~b~~~~~~bb~~~~~~~b~~~b~~bbbb~~~bb~~~~~~bb~~~~~bbbbb~~b~~~~~b~~
~~bb~b~~b~~~~~b~~bb~b~~bb~b~~~~~b~~~bb~b~bb~~~~~~~~~bb~b~~~~b~~~~~b~~~~~b~~b~b~b~~~b~b~~~~b~b~~~b~~b~
~~~~b~~~~~~~bb~~~b~~~~~~b~~bb~b~~~~~~~~b~~~b~~~~~~~~~~~~~~~bbb~~~~~~bb~~~~~b~bb~~~~~~~~~~~~~~~bb~~~~~
b~~~~b~~~~~~~~~b~bbbb~~~~~b~b~~~bb~b~~~b~~b~b~b~b~~~~~b~~bbbbb~bb~~bb~~~~b~~~b~~b~~~~~~~~~b~~~~b~~~b~
~~bb~~~~~~~b~~b~~~~~~~bbb~~~~bb~~~b~b~b~b~b~b~b~~~bb~b~~~~b~b~~~~~~~~b~~bb~~b~~bb~~~~bb~~~~~~bb~~~~~~
~~b~~b~~~b~b~~~~~~bb~~~~~~b~~~~~~~~~~~b~~~~b~~~~~~b~bb~bbb~~~b~~b~bb~b~bb~~~b~~~~b~~~~b~~~~bb~~~~bb~~
~~~b~bb~~b~~bb~~bb~~~~~~b~~~~b~~~bbbbb~~~~bbb~~~~~~b~~~~~b~~b~~~~~~~~~b~b~~~~~bb~~~~bbb~~~~b~~~b~~b~~
~~b~~~b~~b~b~~b~~~~~bbb~~~~~~~~~bb~~~~b~~b~~~b~~~~~b~~~~b~bb~~~bb~~~b~~~b~bb~~b~~~b~b~~b~~~~~b~bb~~~~
b~~~b~~~b~~~~~~~~~~~bb~~bb~~~bbb~~~~~bb~~b~~~~~~~b~~~~b~b~~~b~~~~~~~b~~~~b~~~~~~b~b~~~~~b~b~b~~~~~~b~
~~~b~~~~~~~~~bb~~~~~~~~~bb~~~b~b~~bb~~~b~~~~~~~~bb~b~b~~~bb~b~~~~~~bb~~~~bb~bb~~~~b~~~~~~~~~~~b~~~~b~
bbb~~~~~~~~~~b~b~~bb~~~bb~~~~bb~~~~b~~~b~~~~~b~~bb~~~~~~~~b~b~~b~b~~~~b~~~~b~~~~b~~~b~bb~b~b~~~bb~~~~
~~~~~~~b~~~~~~b~~~~b~~~~~~~~~~b~~~b~~bb~~b~b~~~~~~~~~~~~~~~b~b~~~~~~~~~bb~~~~b~~b~~~~b~~~~~~~~~bb~~~b
~bb~b~~~~~b~~~b~bb~b~~b~~~~~b~~~~~b~~~~~b~~~bb~~b~b~~~~~b~b~~bb~~~b~b~~~~~b~~~~~bb~~~~~b~~~b~~~~~bb~~
~~~~b~~b~~~~~~b~bb~~~b~b~~~bbb~~~~b~~b~~~b~~~~~~~b~~~~b~~bb~~~~~~bbb~~~~b~~~~~b~b~~~~b~b~~~~bbb~~~~b~
b~~b~~b~~b~b~b~bb~~~~~~b~~b~~~~bbb~~~~~~~~b~~~~b~~~~~~b~~~b~~~~~bbb~~~~~~~~~~~~b~~~~~~~bbb~~b~~~~bb~~
b~b~~~b~~~~~~~bbb~bb~~~~~~~~~~~~~~~~b~b~~~~~~~b~~~b~~~~~~~~~~~~b~~~~~~~~b~b~~~~~b~~~~~~~~~~b~~~~bb~bb
~b~~~~b~bb~~~bS~~b~~~~~~bbbbb~b~~~b~b~b~~bb~~b~~b~b~~~~~bb~~b~~bb~b~~~~b~~~~~~~~~~~~b~~~~~~b~~~~~~~~~
~~b~~~b~b~~~~~~~b~~~b~~~~~~~~b~~~~~b~b~b~~~b~~~~~~b~~~~~~b~~bb~b~~~~~~~~bb~~~b~b~b~~~~~~~~~~~~b~~~~~~
~b~bb~~b~b~bb~~~b~~~~~~~~~~~~~~~~~~~~b~bbb~~~~~~bbb~~~b~~~~b~~~~bb~b~~~b~~~~~b~~~~~~~~~~~b~~b~~~~bb~b
~~b~~~~~~b~~bb~~~~~b~~~b~~~~~~~b~bb~~~~~~~bb~~bb~~~~~~~b~~b~~~~~~bbbbb~~~~~~~~~~bbb~~~~bb~~~~~~~bb~b~
~~~~b~~~bbb~~~~~~~~~~~~~b~~bb~~~~~~b~~~~~~bb~~~~~~b~bb~~bbb~b~~~~~~~b~bb~bb~~bb~~~~b~~~~b~~~bb~~~~b~~
bbb~b~~~b~~~~~~~~b~~b~~b~~b~b~bb~b~~~~b~~~~b~~b~bb~~~~~~~b~b~b~~b~b~~~~~~~~~bbb~bb~~b~b~~~bb~~b~~~~~~
b~~~b~~~b~~~~~~bb~bb~b~bb~~b~~~~~~b~~~~bb~~bbbb~bb~~~~~~b~b~~b~~~b~~b~~~~bbb~b~b~~~~b~~~~b~b~~~~~~b~b
~~b~b~~~~~bb~bb~~~b~b~~b~~~~bbb~~bb~~~b~b~~~~b~bbb~b~~~~b~~~~b~~b~~b~~bb~b~b~b~~~b~~b~~~~~bbbb~~b~~~~
~b~bb~~b~b~~b~~~~~bb~b~~bbb~b~~~b~~~~~bb~~b~~~~~b~~~~b~~~~~~~~~~~~~~~b~~~~~b~b~~b~~~~~~~bbb~b~~~b~~~b
~~b~~b~bb~b~b~~~b~~~~~b~b~~~~~~~~~bbb~~~~b~~~~bb~b~b~~~bbbb~~b~~bb~~~~~~~b~~b~~~~~~~~~~b~~~~b~~~bb~~b
~~~~b~b~~~~~~b~bb~~b~~b~~~~b~~~b~~~bb~~~~b~b~~~b~~~~~~~b~~b~~~~bb~~b~bb~bb~~b~~b~b~~~b~~b~bb~~~~~b~~~
~b~~~b~~~~~~~~~~~~~~~bb~~~~~bb~~~~bb~~~~~b~~~bb~b~b~~~~~~~~b~~~~~~bb~bb~~~b~b~bb~~~b~~~~bb~~~bbb~~~~b
~~~~~~~~bb~~~~~~~~~bbb~~~~~bbb~bbbb~~bbb~b~bbb~~~~~~b~~~~~~~b~b~~b~b~bb~~b~~~b~~~~~b~~~~~~~~~~~~~b~~b
