b~b~~b~~~~b~b~b~~bbb~b~~~~~b~~~~~b~~~~~~~~~~b~~~~~bbb~b~b~~~~b~~~~b~~b~~~bbb~bb~bb~~bbbb~~~b~~bbbb~~~
~bbb~~~b~bb~~b~~~b~bb~~b~~~~b~~~~b~~~~~~~~~~~~~~~~~bb~b~b~~~bbb~~~~~bbb~b~~~~~b~~~b~b~~~bbb~b~~b~b~~~
b~~b~~~b~~~bb~b~~~~b~~~~b~~~~b~~bbb~~b~bbb~bb~~~~~b~~~~~~~b~~~~~~b~b~~b~~~bb~~~~~b~~bbbb~~~~bb~bb~~~b
b~~~~b~b~bb~~b~b~bbbbb~~~~~b~b~b~bbbbb~~~~b~~~~~~bb~~~~~~~~~~~~b~b~b~~~~~b~~~~~~bb~bbb~b~~~~bb~~b~b~~
~~~b~b~~~~b~~b~~b~~b~b~b~~~b~~~bbb~~~~~~~b~~~~~~~bbb~~~~bb~~~~bb~bb~~bb~b~b~~bb~~~~bbbb~~~~~~~~b~~~~~
b~bb~~b~~~~~b~b~~~bb~bb~~~b~~bb~b~~~b~~b~~~~~b~~~b~~~b~~b~~~bb~bb~~~~~bb~~~~bb~~~b~~~bb~b~~~b~~~bb~~~
~b~~bb~~~~~b~~b~~~~~b~~~b~~~b~~~~~~b~b~b~b~bb~~~b~b~b~~~~bb~~b~~b~bb~~~~~~~b~~~~~~~~~~~~~~~~~~~b~~~~~
b~~~~bbbbb~~~b~b~~b~~~b~~bb~~~bb~~~b~b~~~~b~~b~b~~~~b~~~~~bb~b~~bbb~~~~~~b~~~b~~~~~~bb~~~~~~~~b~~~~b~
~~~~~bb~~~~~b~~b~~b~b~b~~~~~b~~~~~b~~~bb~~~~b~bb~bbb~b~~~~~b~b~~bb~~~b~~~~~~~~~~~b~~~~~~b~b~~~~~b~~~~
~~~~~bb~~b~~~b~~~~~~b~~bb~bbbb~~~~~bbb~b~~~~~~b~~~b~~bb~~bbb~~~bb~~~~~~~~b~~~~~~~~b~~~~~~bb~b~b~~~~~~
~~bbb~~~~~~~~~~~~~~~~~~~~b~~~~bbbb~b~~~bb~~~~b~~~b~b~b~~b~~~~~~b~b~bb~~~~~~~~~b~b~b~~~~~b~b~~~~bb~~~b
~b~~~~~~~~~~b~~~b~~~~~~~~~b~~b~~~~b~~bb~~~~~b~b~~~b~~~~~b~b~~bb~~~~b~~b~~bb~~b~~~b~b~b~~bb~~~~~b~~bbb
b~~~b~~~~~~~~~~~~b~~b~b~~~~~~bb~~~b~bb~~~~bb~~~~~~b~~~~bb~b~~~bbb~b~b~~bb~~~~~~~b~~~~bb~bbb~~bb~~~bb~
~~bb~bb~~~~~~~~bbb~b~~b~~bb~b~~~~b~b~~~~~~b~~b~~~~~~~~~~b~b~~~~~b~~~~~~~~b~b~b~~~~~~~~~~~b~~~~~bb~~~~
b~~~~bb~~bb~b~~~~bb~bb~~~~~bb~~bb~~~~~b~~b~~~~~b~b~b~~b~~~b~~bb~~~~b~~~~~~b~~~~b~~bb~bbb~~~~~~~~b~b~~
~~~b~~~~~~~~b~~~~~b~~~b~b~b~~bb~bb~bbb~~~~~~b~~~~~~~~~~~~~~~~~~~~~~~b~~b~~b~~b~bbb~bb~~~b~~~~b~bb~~b~
b~~~bb~~b~bb~b~bb~~~bb~~~b~~~~~b~~~~~~~b~~~~~~b~~b~~~b~bb~bbb~b~b~bb~~~~~~bb~~bb~~b~~~~b~~~~~bb~~b~~~
~~~~b~b~~bb~~~~~~~~~~~~b~b~b~~~~~b~~~~~~bb~~b~~b~~b~~~~~bb~b~bb~~~~~~~bbb~~~b~~~~b~~~b~~bb~~~~bb~bb~~
bb~~b~~~~b~~~~~~bb~~~~~~~b~~b~~~~bb~b~~~~~~b~~~~b~bbb~b~~~b~~b~~~~~~~~~~~~b~~~~b~~~~b~~~~b~~~~~~~~~b~
b~~~b~~~b~~~~~~b~~~b~~~~~bb~~b~~~bb~~~~b~~~~b~~b~~~~~~~~b~~~~~b~b~~~~~b~~~b~~~~b~~~~b~bb~~~~bbbbb~~~~
~~~b~~~~~b~~b~~b~~~~~b~~b~~~~~~bbb~bb~~~b~~b~bb~~~~~~b~~~bbb~bbb~~b~~~~~~~~b~b~~~~b~~~bbb~~~~~bb~~~~~
~b~~~~~~b~~b~~bb~~~~~~~~~b~b~~~~~bbbbbb~~~~~~~~b~b~~bbb~bbb~~~~~~~b~b~~b~~~~~~bb~b~b~~b~~~b~b~~~~~~~~
~b~~~~bb~~~~~b~~b~~~~~bbbb~bbb~~~bbb~~~b~~~~~~~~b~~b~~~~~~~~~~~bbb~b~~~~~~b~~bbbbb~~b~~~b~b~~b~~b~~~~
~b~~bb~b~~~~~bb~~b~~~~b~b~~bb~~~~~~b~~b~b~~~~b~b~~~b~~b~~~bbb~~~bb~bbb~~b~b~~~~~~~~b~~~~~~~~~~~b~bb~~
~b~~b~~bb~~b~bb~~~~~b~b~b~bbb~~~~~bbb~~~b~~~b~bbbb~~~b~~~~bb~~~~~~~~~~~b~~b~~b~~~b~~b~b~~b~~~b~~~~b~b
~~~~~~bb~~~bb~~~b~~b~~~~b~~~~~~~~~b~~b~~b~b~bb~bb~~b~bb~~~b~b~~bb~~~bbbbb~~b~b~b~~~b~~b~b~~~~b~~b~bb~
~~~b~~~~b~~b~~~b~~~~~~b~b~b~~b~~b~~~b~b~~~~~b~b~b~~~b~~~~bb~~bb~~~~~b~~~~~b~b~~bb~~bb~~~~~~bbb~b~~~~~
~b~~bb~~~b~b~b~~~~~~b~~~bbbb~~~~b~~b~~~~b~~b~~~~~~~~~~b~~~~~~~bb~b~~~~G~bbbb~~~~b~bb~~b~b~b~~~bb~bbb~
~b~~~~~~~~~bb~b~b~~~~~~bb~~~~bb~~~~b~~~~~~~~~bb~b~~~~~bb~~b~~~~~~b~b~~~~~~~~~~b~~~~~b~bbb~~~~~~~~~b~~
b~~~~~~bbb~~b~~~~~b~~~~~bb~bbb~~~~~~~~b~b~~~~~~~b~~~~b~~~~b~~b~~bb~b~~~bb~b~b~b~~~~~b~~~b~~b~b~~b~b~~
~~~~~b~b~bb~~~~~~~~b~~b~~~~b~~~~~~b~~~b~~~~b~~~b~~~~b~~~bb~bb~~~~~b~b~~b~~~~~~b~~~~~b~~~~~bb~~~~~b~~b
~b~~bb~b~b~~~~~b~~~~~~~~~~~~~~b~~~~~b~bb~~~~~bbb~~b~b~bb~~~bb~~~~~~b~~~~bbb~~~~~~bb~~bb~bbb~~~~~~b~~b
b~b~bb~~~~b~~~bb~~~b~~~~~~~b~~~b~~bbbb~~~b~~~~~bbb~~~~~bb~~~b~b~b~bb~~bb~bb~b~~~~~~~~~~~~b~~~bb~~~~~b
~~~~~b~~~~~bb~b~b~~b~~~b~~~b~b~~~~~b~~~~b~~~~~~~~bb~~b~b~~S~b~~~~~~~~~b~~~~~~~b~bbbb~~~~b~~~~~b~b~~~~
~~b~~~~~~b~~~~~bbb~~~~b~~~bbb~~~b~~~~b~~b~~bb~b~~~~~~~~~b~b~~~~~b~~~b~~~b~~~~~~~b~bb~bbb~b~~b~~b~~b~~
~~bb~~b~b~bbb~~b~~~~~~bbbb~~~~~bb~b~~b~~b~bb~b~~b~b~~b~bb~~~b~b~b~~b~b~b~~~~~~~~~b~~~~b~~bb~b~bb~~b~~
b~b~~b~~~b~b~b~~b~~~~b~bb~~b~b~~b~bb~b~b~~~~~~~b~b~~~~~~b~~~~~~~b~~~~~~~~~bbb~~~~bb~~~~b~~bb~~~~~~~bb
~~b~~~~bb~b~~b~~~~~~~~b~~bb~~~b~~~~~bbb~~b~b~b~~~b~~~~~bb~~bb~b~bb~~~~~b~~~b~~~b~~~~~b~~~~b~~b~~~~~~~
b~~bb~~b~~~~b~~~b~~~~~~~bb~~~~~b~~~b~~b~bb~~~~~~~~~~~~~~~~~b~bb~b~b~~b~~b~~~~b~~b~~bb~~~~~~~~~~~~bb~~
~~b~b~~b~~~~~~~bb~bb~b~b~~~b~~~~~~b~~b~b~bb~~~b~~b~~b~b~~~b~~b~~~~~~~~~b~~~b~~b~b~~~~b~b~~b~~~~~~~b~~
~b~~~bb~~b~~~~~~b~~b~~~~~~~b~~bb~~~b~bbbb~~b~~~~~~~~bb~b~b~~~b~~~bbb~bb~b~~~b~~~~~~~~~b~~~~~~~b~b~~bb
~b~~~b~b~~~~~~b~b~~~~~~~bb~bb~~b~b~~b~b~b~bb~~b~~b~~b~~~~b~~~bbb~~b~~~~~~~~b~~b~b~~~~~bb~~bb~~b~~~~~~
~~~~bb~~~~bb~~~~b~~bb~b~b~~~~~~~~~~~~b~~~~b~~~~bb~~~~~~b~~~bb~~~~~bbbbb~~~bb~b~b~b~~~~~~b~~~~~b~~~~~~
b~~~b~~b~~~~~~~~~b~~b~~~~~~~~~b~~~bb~~~b~~~~~b~~~~~~bb~bbbbb~~b~bb~~~~~~~~~bb~~~bbbb~b~~~b~bb~bb~bb~~
bb~b~~~~~bb~bb~~~~~~b~~~~~~b~bbbb~~b~~~~~bb~b~~~bb~~~~~~b~b~~~b~~~~~~~b~~~~~~b~~~~~~~~~bb~b~~~~~b~~b~
b~~b~bb~~~~~b~~~~~~~~b~b~~b~~~~~b~~~b~bb~b~bb~~~b~bb~b~~b~~~~~b~~~b~~~b~~~b~~bbb~~bbb~b~b~b~~b~~bb~~~
bb~b~~~~~~~bb~~b~~~bb~b~~~bb~b~bb~~~~~~~~~b~~b~~~~~~~~~bbb~~b~~~~bb~b~~~~~~~~b~b~~~bb~b~b~b~b~~b~b~b~
~~~~b~~~~~~b~~~~bb~~~~~~~b~b~~bb~~b~bb~~~~~b~~~~~b~~bbb~b~~~bbb~b~~~~b~~~~~~b~~~~~~bbbb~~~~~~b~~~bb~~
~~b~b~~b~~~~~bbbbb~~~~~~~b~~~~~b~~~~b~b~~b~~~~~b~~~~~~~~~b~b~~~~~~~~~b~~~~~b~~~~~~~bb~bb~~b~~~~b~bb~b
~~~bb~~~~~~~~b~~~~bb~~~~b~~~~~~~~~b~b~b~~b~~~~~~~~~~b~~~~b~~~~~~~~~~~bb~~~~b~~~~~~b~b~~~~b~~~b~bb~~~b
~~~b~~~~~~~~b~~b~b~bb~~~~b~b~~~~~~~b~~~~b~~~bbb~b~~bb~~~b~~~~~~~b~bb~~~~~~~b~b~~bb~~b~~~~~bbbb~~b~~~~
~b~~~~bbb~~~~~~b~~b~~~b~~~bb~b~b~~~~~~~~~~~~b~~~b~~~b~~~~~~~~~~~~~~b~b~b~bb~~~~b~~~~~~b~~b~~~~~b~~~~b
b~b~~~~~~~~~~~~~~~b~~~~~b~~bb~~b~~~~~~bb~~b~~b~~b~~~~~bb~~bbbb~~b~~~~~~~bbb~~bbb~~~~~~~bb~b~b~~b~bb~~
~b~~b~~~~~bb~~bbb~~b~~b~~~~~bbb~~bbb~b~~~~~b~b~~~~~~bb~bbb~~~~~~~bb~~~~~~b~~~~~b~~~~~b~b~~b~~b~~bb~~b
b~~~~~~~~b~~~~~b~~~~~~bbb~b~b~~~b~~b~b~b~~~~~~~~b~b~~~bb~~~~~~~~~~~~bb~~~~~~bb~~~~b~~b~b~b~~~~~~~~b~~
b~~~b~~b~~~~~~~~~~~~~~~~bb~~~~~bb~~~b~~~~~b~~~~~~~~~~~~~~~~~~~~~~~~~~~~b~~~~~~~~~~~~b~~~~bbb~~b~b~b~~
~bb~bb~b~~b~~~~bb~~~~~~b~~b~~b~~b~~~~~~~~~~~~~~~~~b~bbb~b~b~bbb~~b~bb~~~b~~~b~~~b~~~bb~bb~~b~~~~~b~~b
~~b~~b~b~~~bbbb~bb~~~~b~~~~~~~b~~~~~~~~~~b~b~~b~b~~b~bb~~bb~bb~~b~~~b~~~~bbb~~b~b~b~bb~~~~~~b~b~~~b~~
~~~~b~b~b~~~~b~~bbb~~~~b~~~b~b~b~~~~~~~b~~b~~bbb~~bb~~bb~~~~~~~~~~~b~~~~b~~~~b~b~~~bb~~bbb~~~b~~~~~~~
b~~~~~~~~~~~bbb~b~~bb~b~~b~bb~b~b~~b~~~~~~b~~~b~~~~~~~bb~b~bb~b~~~~bb~~b~~~~b~~~~b~b~~~~b~~b~~~~~b~bb
~bb~b~bb~~~~~~~~~~b~~b~~~b~b~~~b~~~~~~~b~~~~~~b~~bbbb~~~~bb~~bb~~~~b~~b~~~~b~b~~~~~bb~bbb~~b~b~~bb~b~
b~~~~~b~~~~bbbbbb~~~~b~~~b~~~b~~b~~~~b~~b~~~b~~~bb~~b~~b~~~~bb~~~~~~~b~~~~~~b~~~~bb~~~~~~~~b~b~~~~~~b
~~~~bb~b~~b~~~bb~~~~~b~~~bb~bbb~bb~~bbbbbb~~~~~~~~~b~~~~b~~~~~~b~b~~~~bbb~bbb~bbb~~bb~~b~~~b~~~~~~~~b
~~~~~~b~~~~~b~~~~~~~~~bb~~~~~b~~bb~b~~~~~b~~~~~~~~~~~~bb~~~bbb~b~b~b~b~~~~b~~~b~~~b~~b~~~~~~~~~~~b~b~
~b~~~~~b~bb~b~b~~b~~~~~bb~~~~~~~~~~~~~bb~~bbbb~~~~bb~~~~~b~~~~b~~bb~bb~b~~~~~b~~b~~~b~~b~~~bb~~~b~~~~
~~~~~b~~b~b~b~~~~~~~~~~bb~~~~~~~~~~b~~~~~~b~~b~~~~b~~~~~b~b~~~~~b~~~~~~~~~b~~~bbb~~~~~~~~~~~~~bb~~~~~
~~bb~~~~b~~b~b~~~~b~~~bb~~~~bb~~~~~~~~~b~~~b~b~~~bb~~b~b~~~~~~~~~bb~bb~~~b~~b~~b~~b~~~~~~~b~~~~~~~~~~
b~~~~~~~~~~~b~~~~~~~~b~b~b~~~~~~b~~~~~~~~~~~~~~~b~bb~~~b~b~~~~~~bb~~~~~~~~~b~~~~~~b~~~~b~~bb~~bbb~bbb
~b~~~~~~~~~~~~b~bb~~b~~~b~bbbbb~~b~b~~bb~~~~~~~b~~~bb~bb~~~~b~~~bb~~b~~~~~~~b~b~~bbb~bb~~~~~b~~~bbb~~
~b~~b~~b~~~~~bb~~b~~~~b~~~~~b~~~~~~~~~~~~bbb~b~b~~b~~~~~b~~~~~~~~~~~~~b~~~~~~~~~~b~~~~bb~b~~~bb~~~~bb
~~~~~~b~~b~b~b~~~~b~bbb~~~bb~~~~bb~~~~~~~b~~bb~~~~b~~~bbb~~b~~b~~b~~b~~bbb~~~~b~~~b~~~~~bbb~~~~~b~~~b
b~b~b~b~bbb~~~b~b~~~~~b~~~bb~~b~~bbb~~bbb~b~~~~~~~~~bbb~~~~~~~~~bb~~b~~~~b~~~~bbb~b~~b~~~b~~~b~~~b~~~
~~b~~~~~~~~bb~b~b~b~b~~b~b~b~~b~~~~~~~~~~~~~b~b~~~b~~bb~~~~~~b~bb~~bbb~b~b~~~~~b~~~~b~~~~~bb~b~b~bb~b
~~b~bb~~bb~~~bb~~bb~~b~~~~b~~bb~bbb~~~~b~~~~~~~bb~~~~~~~~~~bb~~~b~b~bb~~b~b~~~~b~~~~~b~bb~b~~~bb~~~~b
~b~~b~bb~~~~~~~~b~b~~~b~~bb~~~~~b~~bb~~b~~b~~b~~~~~~bbb~~~~b~~~~b~b~bb~~~~~~~bb~~b~~~~bb~b~bb~b~b~~~~
~~~~~~~~~~~~~~~~~b~~~~~~bb~~~~~~b~b~~b~~~~b~~b~b~~~~~~~~~b~~~b~b~~~~~b~~bbb~~~~~~~~~b~~~~~~~~~b~~~~b~
~b~~~b~b~~b~~b~~~bbbbb~~~b~~~~~~~b~~~b~~~b~b~b~~~~~bbb~~~~~~~~~~~b~~~~bb~~~~~b~~~bb~~~b~~~b~~~~b~~b~b
b~~~b~b~~~bb~~~~~~~~~~~~~~~bb~~~bb~~~~~bbb~~b~~b~b~~~b~~~~b~~~~~~~~~~b~~b~~~b~~~~b~~~~~~~~~~~~~~~b~~~
~~~~b~~~~~~~~~~~~~~~b~~~~~bb~~~b~b~~~~~~~~~b~~~~~bb~b~b~bb~bb~~~~b~~~~bbb~b~bb~b~~~~~~~~b~~b~~~~~~~~~
~~~b~~~~~bb~~~b~~b~b~~b~b~bb~~~~b~bb~~~~b~~b~~b~~b~~~~bb~~b~b~~bb~~~~~~b~~~~~b~b~~~~~~b~b~~bb~b~~b~~~
~b~~~~~~~~~~b~~~~b~~bb~~~bb~bb~~b~~~~~~~b~~~~~b~~~bbbbb~~b~~~b~b~~b~~b~b~~b~~~~~~b~~b~~b~~~b~~~~~~~~~
b~~b~b~~~b~~b~~~~b~~~~bb~b~~~~~~~~~~~~b~~~~~~~~~~bb~b~~~~b~~bb~~~b~bb~~~~~~bb~~~~~~b~~~b~b~b~~~~~~~b~
bbb~~~~~~~~b~~~~~~b~bb~~~~~~~~b~b~b~~~~~~~bbbb~~~b~~~b~b~~~~~~~b~~~~~b~~~~~~b~~~bb~~~~~~~b~~b~b~~~b~b
bb~b~~~~~b~~b~~~~~~~~~b~~~~~bbb~~~~b~~b~~b~bb~~~~~b~b~bb~~~~~~~~b~~~~bb~~~b~b~~b~b~~bbb~~~~~b~~~~b~~b
b~~~~b~bbbb~~~~~~~~~bbb~b~b~~~~~~bb~~b~~~~b~b~~~~~~b~~~b~~~b~b~~b~b~b~bb~b~~~b~~~~~~~b~~~~b~b~b~~~b~~
~b~~~b~~~~~b~~~~~b~~b~~~~~~~b~~~~b~~~~~~~~~~b~~b~~~~~~bb~~~~~~b~~~b~bb~~bb~~~~~~~b~b~~~~~~~~~~~bb~b~b
b~bb~~~~~b~~~~~bb~~~~~b~b~~~~b~~~~~bb~~bb~~~bb~~b~bbb~~~~b~~b~~~bbb~~~~~~~bb~~b~~bbb~~~~~~b~~~~~b~~bb
~bb~~~~~~b~~b~~b~~b~~~~~~~b~~~~~b~b~b~~b~b~~~~~bb~~bb~~~~b~bb~~b~~~~~~b~~b~~~~~~~b~b~~~~~b~~b~~~~~~~~
~~b~~~b~b~~~b~b~~~~~~~bb~~~~~~~~~bbb~~~~b~b~bb~b~b~~~b~~~b~bb~b~b~b~b~~bbb~~b~~~~b~~~~~~~~~b~b~b~~~b~
~~~~~~b~~bb~~b~b~b~~~~bbb~~b~~~~~~~~~~b~~~~b~bb~~~~b~~b~~~~~b~~~~~~~~bb~bb~~~~b~~b~~~~bb~~~~~~~~~bb~~
~~~~b~~~b~~b~~b~~b~~~~~bbb~~b~~~bb~bb~~~~b~~~b~~~~b~bb~~~~~bb~~bbbb~~~~~~~~~b~~~~~~~b~~~~~~b~~b~~b~~~
~~~b~~b~b~~b~~b~~~~~~~~~~~b~~~~~~~~~~~~b~b~~bb~~~~~~~~~~bbb~~~~~~bb~~bbb~~b~bb~b~b~b~~b~~~~b~b~~~b~~~
~~b~~~~~b~~~~~~~~b~bb~b~~~~~~b~~~bb~~b~~~~~~~b~bb~~~~~bb~~b~~~~~~~~~~~bb~~~~bb~~~~~~~b~~~b~b~~~~~~~bb
~~~~~b~b~~b~~b~~b~~~bbb~~~~b~~b~~~b~~b~b~~~~bb~~~~~b~b~~~~~~~b~~~~~~~~~~~~bb~~bb~~~~b~~~b~~~b~b~b~~~b
~~bb~~~~~~~~~b~~~bb~~~b~~~b~~b~~~b~b~~~~b~~~~~~~b~~~bb~b~~~b~~~~~~b~~b~~~~~~~b~b~~bb~b~b~~~b~b~~~bb~~
~~~~b~~b~~~~b~~bb~~~~~~~~bb~~~~~bb~~~~~~~b~~b~~~~~~bb~~~~~~~~~b~b~~bb~~~~~b~bb~~~~~~b~~~bb~~~~~~b~~b~
~bbb~~~b~~~bb~b~~bb~~~b~~~b~~~~~~~b~~b~~~bb~~bb~~~~~~~~~b~~~~b~~~~~~~b~~~~b~b~~~~~b~~bb~b~b~b~b~~~~~~
~~~b~~~b~~~b~~b~b~~~b~~~~~b~bbb~~~~~b~~~b~~b~~~~~~~~~b~~b~~~~b~~b~b~~~b~~~~~~~~~~bbbbb~~~~~b~~~~~~~~~
bb~bb~b~~bbb~~~~~bb~~~b~~~~~~bbb~~~~b~~~~~bb~~~~~~~~~~~~b~~~bb~bb~~~~~~~~b~~~~b~~~~bbb~bb~b~~~~b~~b~b
b~~b~~~~~~b~b~~b~~~~b~b~~b~bb~b~bb~b~~~~~~~~~~~~~~~~~~~bb~~~~~~b~~~bb~bb~b~~~bbb~~~~~~~~b~~b~~bb~~~b~
~~b~b~~b~bb~bb~~~b~~~~~~~~~~~~~~~~~~~~~~b~~~~~~b~~~~b~~b~~~b~~~b~b~~b~b~~b~~~~~~~~~~~~bb~b~b~b~~b~~~~
