~~~~~~~~~~~b~b~~~~~~~~~~b~~~~~~~b~~b~b~~b~b~~~b~~b~~~b~~~b~~bbbb~~~~~b~~~~~b~b~~~b~~~~~~~~~~~~~~~~~~~
~~~~~b~~~b~b~bbb~~b~~b~~~~~b~~bbb~b~~~~~~~~~~~b~~bb~~~~b~bb~~~bb~bb~b~b~~~~~~~~~~~~~~~b~~bbb~~~~~~bb~
~~~~~~~~b~~~bbb~~b~~bb~bbb~b~bb~~bb~b~b~~b~~b~b~~b~b~b~~b~~b~b~b~~b~~~~b~~~~~~~~bG~~~~~bb~~bb~~b~~b~b
~b~~~~~~~~~~~~~~~~~~b~~bb~~~~~bbb~~~bb~~bbb~~bb~~~~~~bb~~~~~~~~b~~~~~~~~~b~b~~~~~~~b~~~~b~~~~b~~~~~b~
~b~~~~b~~~~~~b~~~~~~~~~~~~b~~b~~b~~~b~~b~~~~~~~~~~b~~b~~~~b~~~~~bb~b~~~~~~~~b~~~~~~~~~~~bb~b~~~~~~~~~
~~~b~b~~~~b~~~~~~~~b~~bbb~b~~b~b~~~b~b~b~~~~~~~~~~bb~~~~b~~~b~~~bbb~~~~b~~b~~~~~~~~~~~b~b~~~b~b~~~~bb
~~b~~b~~~~b~bb~b~~~~~~b~~~~b~~~~~~~~~~b~bb~~~b~~~~b~~b~~~~~~~b~~b~bbb~b~~~~bb~~~~~bbb~~bb~~~~~~~bb~~~
~~~~b~~~~~b~b~~~~b~b~~~~~b~~~~~b~~bbb~~~~~~~~b~b~~b~b~~~~~~~bb~b~~~~~~~~b~~~~~~bbb~b~~~~~~~~b~b~~~b~~
~~~~~~bbb~~~bbb~~~~~~~~bb~~b~~~b~~~~~~~~~bb~~~b~~~~~~~b~~~bb~b~bbb~~~~~~~b~~b~~~b~~b~bb~~b~~b~~~~~bb~
~~~bb~b~bb~~~~~~~~~~~~~bb~b~b~~b~~~~b~b~b~~~~~b~~bb~b~~bb~~b~~~~~~b~~~bb~~bb~bb~~~~~b~~b~~~~~~bb~b~b~
~b~~~~~~~~~~~~~~b~~~~b~~~~b~~~~~bb~b~~b~~b~~b~b~~bb~~~~~~~bb~~~~~~~b~~~~~~~bbb~~~~~~b~~~bbb~b~~~~~~~~
~~~~~~~~~b~~~bb~~b~~b~~~b~~~~~b~b~~b~~~~b~~~~~~~~b~b~b~~bbb~~~~~~~~~~b~bb~bb~bb~~bb~~~~b~~b~b~~~bb~~~
b~~bbbb~~~~~~~b~~~~~bb~~~~~~~~~~~~~~~bbbb~b~~~b~~~~~~~~~b~~~~~b~~b~~b~~~~~b~~~~~~bb~~b~~~b~b~~b~~~~~b
~~bb~b~~~~~~b~~~~~~b~~bb~~~~b~b~~~~~~~~~~~~~b~~b~~~~b~~~b~~b~b~~~~bb~~b~~b~~~~~~~~~~~b~~~~~b~~~bb~~~b
~~bb~~~~~~~~~~~~~~~~~~~~~~b~b~~bbb~~~b~~~~b~b~b~bb~~~b~~b~b~~~b~b~~bb~~~~~~~~~b~~~~~~~~~bb~~~~~~~~~~~
~b~~~~~bbbb~~~~~~~~bb~bb~~~~~~~~~~bbb~~~~~b~b~~~bbb~b~~~b~~b~bbb~b~~~~~~~~~~~~~~bb~~~~~~~~~~~~b~b~~~b
~~~b~b~~~~~~~~~bb~~bb~~~b~b~b~~bb~b~~~~~b~~~b~bb~~~~b~b~~b~~~b~~bb~~~bb~~~~~~~~bb~bbbb~~~~b~~~~~~~b~~
b~~~~b~b~~b~~~~~~~~~~b~~~b~b~~~~~b~b~~bb~~b~b~~~~bbb~~b~~~~~~~b~~b~~~b~~~~~~~~~~~bbb~~~bb~~b~b~~~~~~~
~b~~~bb~~~b~~~~b~bb~b~~~~~~~~~~bb~b~~~b~~b~b~~~b~~~b~~b~~~~b~~~~~bb~b~~~~~~~b~~~~~b~~~~bb~~~b~~~b~bbb
~b~~~b~~~~~~~~~bb~~~~~~~~~~b~~~~~~~b~~b~bbb~b~bbb~~~b~bb~~~~b~b~b~~b~~~~b~~~~~~~~~bb~~~~b~b~~~~b~b~b~
~~~~b~~~~~~~~b~~~~~~~~~bb~b~~~~~~~~~bbb~~b~~~~~b~~~~~~~~b~~bb~~~~b~b~~~~b~b~~~~~b~~~~~~~~bbb~b~~~~~b~
bbbb~~~~~~~b~b~~~b~~~~~~b~~~~b~~~~~bb~b~~~~~~~~~~~~b~~bb~b~~~~~~b~~bb~b~~~~~~b~bbb~~~bb~~~~~~bb~~~~b~
~b~~~~~~~~~b~~bbb~~b~~~~~~b~~~~~~~~~~~~~~b~~~bbb~b~~bb~~~~~~~~b~b~bb~~bbb~b~b~~~~~~~~b~bb~~~~~bb~bb~~
~~b~b~~~~~~~bbb~~~b~~b~~b~~~~~b~~~~~~~~~~~~~b~~~b~~~~b~~~~b~~b~~bb~~~~bb~~~~b~~~~~~~~~b~~~b~~~~~~~~~b
~~~~~bb~~~b~b~b~b~b~b~b~~~~~~~~~~~bbb~~b~~~~b~~b~~~~~~~~~~b~b~b~bb~~~b~~~~b~~~bb~~~b~~~~~~b~b~~~~~~~b
~~~~~~~~b~~~~bb~~~b~~~~~~~b~~~~~~~~~bb~~~~~~~~~~~~b~~~b~~b~b~~~~b~~~~~~bbbb~~~~~b~~b~b~~b~~~bb~b~~~~b
~~b~~~~~~~~bb~b~b~~~bbb~bb~~~~~b~~~bb~b~b~b~b~~bb~~b~~~~~~b~~~~~~~b~b~~~bb~~~~~~~~b~~b~~bb~~b~~~~~~~~
~~~~~bb~bbb~~~~~~~~~~~~b~~~b~bb~~~~~~~~~~~~b~~~bbb~b~~b~b~~b~~b~~b~b~bb~~~bb~b~b~~b~~b~b~~~~bb~bb~~~~
b~b~~~~~~~~~bb~~~~~~~~~~~~~~b~~~~~~~~b~bbb~~~~~~~~b~~~~~~~b~~~~~~~b~~~b~b~~~~b~bb~b~~~~b~b~~b~~~b~~~~
~~~~bb~~~~~~~~~~~~~bb~b~~~~~b~~b~~~bb~~b~bb~~~~~~~bbb~~b~~~~~~~b~bb~~~bbbb~bb~~~~b~~~~~~~bb~~~~~~b~~~
bbb~bb~~b~bbb~b~~~~~~~b~~~~~~b~b~~b~~~b~b~b~bbb~~~~~~b~b~b~~~b~~b~~~~bb~~~~b~~~~~bb~b~b~b~~~~b~~~~~~b
~bb~~b~~~~b~~b~~bb~~~~~~~~~~b~b~~bb~~~~~bb~~bb~b~~~~bb~~~~~~~~bb~~b~b~bbb~bb~~b~~~~~~~~b~~b~~~bb~~bbb
~~bb~~~~~bb~bb~~b~~~~~~~~~~b~b~~~bb~~~~~~b~~b~~b~b~~b~~b~~~~~~b~~~~b~b~~~b~~~~~bb~~~~~~bb~~b~b~~~~~~~
~~~~bbb~~~b~b~b~b~~~~~~bb~~b~~~b~~~~b~b~b~~bb~~bb~~b~b~~~~~~b~~~bb~~~~b~bb~b~b~~~bb~bb~~~b~~~~~~~~~~~
~~bb~~~b~~~b~bb~bbb~~~b~b~~b~~bb~~~bb~~~~~b~~~~~b~b~~~b~~~~~~~~~b~~~b~~~~bb~~~~~~~~b~~~b~~b~b~b~b~~~~
~~~~~bb~~~~~~~~~~b~b~b~~~b~~~~b~~~~bb~~b~~bbb~~~b~b~~~b~~~~~~~~~~~bb~~~bb~b~~~~~~~~~bb~bbb~~~b~~~b~~~
b~~~~~~~~b~~~~~~~~~~~b~b~~~~~~bb~~~~~~~~~b~~~~~bb~b~b~~~~~bb~~~~b~~~~~~~~~b~bbb~~~~~b~bb~b~~~~b~~b~b~
~~bb~~~b~~b~~~~~~~~~b~b~~b~b~~~~bb~b~~~~b~~~~~~~~b~~~~b~~b~~~~~~~~~bb~~~~b~~~bb~~~~~bb~~~~~b~~bbbb~~~
b~~~~b~~bb~~~~b~b~~~~~b~b~~~b~~bb~~~~b~~bb~~b~b~b~~bbbb~b~~bbbb~~~~b~b~~bb~~b~~~~~~~~b~~~~b~b~~~~~~b~
~~~~b~~~~~~~bb~~~bb~~b~~~~~b~~~bb~~~~~~bb~~b~~b~~~~b~~~~~~~~bb~b~~~~~~b~b~b~b~~~~~b~~~~b~b~~b~~b~~~~b
~bbbb~b~~~~b~~~b~~~~~~~bbbb~~~~~~~bbb~b~~~b~~~~~b~~~~~~~~~~~bb~~~bbb~~~~~~bbb~~~bb~~b~~~~~b~~b~~~~~~b
b~~~b~~b~bb~~~~~bb~~~b~bb~bbbb~bb~b~~~b~b~b~~~b~~b~~~~b~b~~b~~bb~b~~~~~~~~bbbb~~~b~b~~~~~~b~b~bb~~b~~
bbb~~~b~b~~~~~~b~~~~~~~~~~b~bb~~b~b~~~~~bb~~~bb~~bb~b~~~~~~~~~~bbb~~bbbbb~~~b~~~~~~b~b~b~~~~~~~bb~b~~
~~~~bbbb~~~b~~~~~~~b~~~~~bb~b~~~~bb~~bb~~~~b~b~~~b~~~b~~bb~~~~~~~~~~~~b~b~~~b~~~~~bb~b~b~~b~b~~b~~~~~
~~~~~~~~~~~b~b~~b~~~~~~~b~~~~~~~~b~~~~~~~~~~~~~~~b~~~~~~~b~~bb~~bb~b~~~bb~b~~~b~~bb~b~~b~~~~~~~~~~~~~
~~~~~~b~~~~~~~b~b~b~bb~~b~b~~~~~~~~~b~~~~~~b~~b~~b~bb~~~~b~~b~~~~~~b~~~~b~~b~~b~b~b~~b~bb~~~~~~~~b~~~
~~~~~b~~~~~~~bb~~b~~~bb~b~~~~~~~~~~~~~b~bb~b~b~bbb~~~b~b~~~~~~~bb~b~bbb~~~~~~~~~~~~~~~~b~~~~~b~b~b~~~
~~~~bb~~~~~~b~b~b~bb~~b~~~~b~~~b~~~~b~~~~~~~b~~~~b~~b~~~b~bb~b~b~b~~~~~b~b~~~bb~~~~~~~b~~~b~~~~~~~b~~
b~~~b~~~~~~bbb~b~b~~b~b~~~~~~b~b~~b~~bb~~b~b~~~b~b~~b~~b~b~~~~~bbb~~~b~~~bb~b~~~~bb~b~~~~bb~b~~~b~b~~
b~~~b~~~b~bb~bbbbb~~~~~~b~~b~~~b~bb~~~~~~~~~~~~~b~~b~~b~b~~b~~b~~~~b~~~b~~~~~~b~b~b~~b~b~~~~~b~bb~~~~
b~~~~~~~b~~bbbb~~~~~b~~~~~bb~b~b~b~~~b~b~b~~b~~b~~b~~b~~b~b~~~bb~~~b~~~b~~~~b~~bb~bb~bbb~b~~~~bb~~bb~
~b~~b~bb~~~~~b~~bb~~b~~b~~b~b~b~~~b~~~bb~bb~~~b~~b~bb~~b~~~~b~~~~b~b~~b~~~~b~~~~~b~~~~~bb~bbbbb~~b~b~
b~b~~bbbb~b~b~~~b~~~~~~b~b~bb~~~~~~~~~~b~~~~bb~~~b~~~bbb~b~~~~~~~~~b~b~b~b~~~~~~~b~~~~b~b~~~b~b~~~~~~
~~b~~~b~~~~~~~~~bb~~~~~b~~b~~~b~~bb~bb~~~b~bb~b~b~~~bb~~~~~bbbb~~~b~~~~bbb~~b~bb~~~~bbb~~~~~~~~~~bb~b
bb~b~~~~~~b~~~~b~~~bb~~~~~b~b~~b~~~~~~~b~~bb~~~~~~~~~bb~b~b~~~~~~~~~~~~~~bbbb~b~~bbbbbb~~~~~~~~~b~b~~
~b~~b~b~bbb~b~~b~~bb~~~~~~~~~~b~bb~~~~~~~b~~~~b~~~bb~~~~~~~~~~~bbb~b~b~b~~~~~~~~~~~b~~~b~~~b~~~~~~b~~
~b~~~~b~~b~~~~b~b~~~~~~~~~~~~~bb~bb~~b~b~~~b~~b~~~b~~~~b~~~bb~~~~~~bb~~~b~b~~~~b~~~~~~~~~~~b~~~~~b~~b
~~~~~~~~~~~~~~~~~bb~~~~~~~bb~~~~b~~~~~~~b~bbb~~~~~~~b~bb~~~~~~b~~~~~~~~b~~~b~~bb~~~~~~b~~~~~~~b~~~~~~
b~~b~~~~~~~~bb~~~b~~~~bb~~~b~~b~b~~~~bb~~~~~bb~~~b~b~b~bbbb~~bb~~~~~~bb~~b~~~b~bbbb~~~b~~~~b~~~~b~~b~
~~b~b~~b~~bbbbb~~~~~~~~b~~~b~b~~~~b~~~~~~~bb~bb~b~~b~~~b~~bbb~~b~~~~bbb~~~~b~~~~~~~~~~~bb~b~~~~b~b~~~
b~~~~~~~~~~b~~~~~bb~b~b~~~~~~~bb~b~~~~~b~~~b~~~b~~~~~~~~~~b~b~~bbb~~~b~b~~~~~~~~~~~~~~~~~~bb~bb~~~~~~
~~~~~bb~~b~b~~~~~~~bb~~~~b~~~~b~~~~~b~bb~~~~bb~~~~~~~bb~~~~bb~~~~~~~~~bb~bbbbbbb~~~~~~b~b~b~~~b~~~~~~
b~~b~b~~bbb~~b~~~b~~~b~~bb~~~bb~~~~~b~b~~~b~~~b~~~~b~~~b~~b~~~b~~~b~bbb~~~~~~b~~~~~~~~~~~~~~~~bb~~~~~
~~~b~~~b~b~~~~bbbb~~~~~~~~b~b~~b~~~~bbbb~~~~~bb~~b~~~~b~~~~b~~~b~b~~b~~~~~b~~~~b~b~b~~~b~b~b~~~~~~~~~
~~~b~~b~~~b~bbbb~b~~~~~~b~~~~~~~b~~b~~bbb~~b~~~~~~b~~~bb~~bb~b~~~~~~~~bb~b~~~~b~bbb~b~~bb~bb~~b~~~~~~
~~b~~~~~~~~~~b~~~bb~~~~b~bb~~~~~b~b~~b~~~b~~b~~~~~b~~~~~~~~~~~bb~~~~~bb~~~~~bb~b~bb~~~~~~~~~~b~~~~bbb
~b~~~bbb~b~~~~~~~~bb~bb~~~~bb~~~~~~~bbb~~~~b~~~~~bb~b~~~~~~~b~~~~bbbb~b~~b~~~~~b~bb~~~~~~~b~b~b~~~b~~
b~~~~~~~b~~~~~b~~b~~b~b~~~~~~~~~b~b~~bb~~b~b~~~~~b~~bb~~~~~~~~~~~~bbbbb~~~~~~~~bb~bb~b~b~~b~~~b~~~~bb
bbbb~~b~b~~~b~bb~~b~~~~~~b~~~b~~~~~~~~~~~~~~b~b~b~bSbb~~~~~~~b~~~~b~b~~bb~~~~b~~b~~~~~~~~~b~~~b~~~~~~
~~~~~~~~~~~~~b~~~~~b~~~~b~bb~~~~~~~~~~~~~~~~~~~~~~b~~~bb~~~~~~b~bbb~~~~~b~b~~~bb~~bb~b~~~~b~~~~~~~~~b
bb~~~~~~bbb~~b~~~~~~~b~~~~b~~b~~bb~~~b~~bbbb~~~~~~~~b~~~~b~b~~~b~~~~~~~~~~~bb~~~bbb~bb~~~~~~~~~~~b~~~
b~~b~~~bb~bbb~b~~~~~~bbbb~b~~~~b~~~bb~bbbb~~b~~~b~~~b~b~~b~~~~bb~~~~~bb~~~b~b~~b~bbbb~~b~~~b~b~~~~b~~
~~bbb~b~~~~b~~~~~~~b~~~~~~b~~~~~~b~b~~~bb~b~~bb~~bbbb~~~~~~~~~~~~~~~~b~b~~b~~b~~~~~~~b~~b~~~b~~~~b~~b
~~~bbb~~~~~~~~~~~~b~b~~b~~~~~~b~b~~~~~~b~~~b~b~b~~~~~~b~~b~~b~bb~~b~~~~~~bb~bb~~~~b~b~~~bbbb~b~bb~~~~
bb~~~~b~~bb~b~~~~bb~~~~bb~b~~~bb~~~~~~~~~~~~~b~~~~~bb~~~~~~~~~~~~~~b~~~~~bb~~~bb~b~~bb~bbbb~b~~~b~~~~
~~~bbb~bb~~bbb~~b~b~~bb~~~~~b~~~~~~~~~b~b~b~~~~b~~~b~b~~~~b~~b~b~~~~~~~bb~~~bbb~~~b~b~~~~~~~bb~~~b~~~
~~~~~b~b~b~b~~~~bbbbb~~b~~bbb~~~b~~~~~~bbb~~~~~~~b~~~~bb~~b~~~~~~~bb~~~b~~b~b~~~~~~~~~b~b~~bbb~bb~~~~
bb~b~~~~b~b~~bb~~~~bbbb~b~~~~~~bbb~bb~~~~~~~~bbbb~b~b~~~b~bb~~~~b~~~bb~b~~~b~b~b~~~~bb~~~b~~b~~~~~~~b
b~b~~~bbb~b~~b~~b~b~~~~~~~bb~bbbb~~b~~~b~b~~~~~~~~~~~b~~~~b~~~bb~b~~~bb~~bb~~b~~~bb~~~~b~b~~~~~~~~~~~
b~~bb~~~b~bb~b~b~b~~~b~~~~b~b~~~~~~~~bb~~b~bb~b~b~~~~~~~b~~~~~~b~b~b~~~~~~~bb~b~~b~~bb~b~~~bb~b~~~b~~
b~~b~~~~~~~~~b~b~bb~~~b~~~b~~~~~~b~~~~~~~~b~b~~~~~~~b~~~~b~~~~~~bb~~~~~b~b~~b~~~~~~~b~~bb~~~~b~~~~~~~
~~~~bb~bb~~b~b~~bb~~~~~bb~~~~~bb~~~~~b~bb~~~~b~b~~~~b~~b~b~b~~~b~~b~b~b~b~~~bb~~~~~~~~b~~~~~~bb~~~~~~
~~b~b~~~~~~~bb~b~~~b~~bb~~bb~~~bb~bb~~~~~~~~b~~~~b~b~bb~~~b~bb~~~~b~~~~b~~bb~b~~~~~~~~~~bb~~~~~~~~b~b
~b~~~b~b~~~~~~~~bb~b~bbb~~b~~~~~~~~b~~~~~b~~~b~~~~~~~~~~~~b~~bb~~~b~~b~~~~b~~b~bb~~~b~~~~~~~~~~bb~~~b
~~~~bbb~~~~~b~b~~~~~~~~~b~~~~bb~~~~~~~~b~~bb~b~~~b~~b~~~bb~bb~~~~~b~b~b~~b~~b~b~~~~b~~b~~~bb~~~~~~~~~
~~b~bbb~b~~~b~~~bb~~b~b~~~b~~~~~~~~~~~b~~bb~~b~~~~~~b~~~~~b~~~~~~~~~~~~b~b~bbb~b~~~~~~~~~~~~~~~b~b~bb
~b~b~bbb~~~~~~bb~~~b~b~~bb~~~~~bbb~b~~~~~~bb~~b~~~~b~~~bb~b~b~b~~b~b~~bbb~~~bb~~bbb~~~~~~~~~~b~~~~~~~
b~~~b~~b~~b~~~~~~~~~bb~b~~~~~~~~~b~~~bb~~b~~~~~~b~b~b~~~~~~~~bb~~bb~~bbb~~~~~~b~bbbb~~~~~~~~b~~~~~~b~
~~~~b~b~~~b~~~bb~~~b~~~~b~~bb~~bb~b~~~~bb~~~bb~~~~b~bb~b~~~~~~~~~~~b~~~~b~~b~~bb~~b~~~bb~b~~~~~b~~bb~
~~~~~~~~~~~~~bbb~b~b~b~~~b~~~b~b~~~~~b~b~~b~b~~~~b~~~~~~bb~~~~b~~~~~~bb~~~b~~~b~bbb~~~~b~~bbb~~~~~b~~
bb~~bb~~b~b~b~b~~~b~~~~~~~~~~~~b~~~~b~~~~~~~bbb~~~b~b~~~~bbbbb~~~~b~bb~~~~~~~b~~~~bb~~~~~bb~~~~~bbb~~
~b~bb~b~b~bb~~~~bb~~~~~b~~b~~~~~~~~~~bb~~~~~b~b~~~~~~~b~~b~b~b~~~b~~~~~b~~~~b~~~bb~~~~~~~~~~b~~~~bb~b
~~bb~b~~~~~~~~~bb~~~~~~b~b~~~~b~~~bb~~~~bbbb~~~~~~b~~~~~~~~~~~~~b~~~~~~b~~b~~~~~bbb~~b~b~b~~~b~~~b~b~
~~b~bbb~bbb~~~~~~~~~b~b~~~b~bb~~~~~~~b~b~~b~~b~~~~~~~~~b~~~b~~~b~~bb~b~~~~~~~~bb~~~~~~~~~~~~~b~~b~b~~
~~b~b~~~~~bb~~~~~~bb~~~~~~~~~b~~~~bbb~~b~bb~~~b~~b~~~b~~~~~b~~bbb~~b~b~b~~~~~~~~~bb~~b~~~~~~bb~~bb~~~
~~~~b~b~bb~b~~b~b~~~~~~~~bb~bb~~~b~b~b~~~~~~bb~b~~~~~~~~~b~~~~~~~bb~~~~bb~~b~~bb~~b~~b~~~b~bb~~~~~~~~
~~b~~~~~~~~~~b~b~~b~~b~~b~~~~~bbbb~~b~~~b~~b~~~b~b~~bbb~~~bb~b~~~~~~~~~~~~~~b~~~~~~~bbbb~~b~bb~bb~~b~
~b~b~bbb~bb~~~b~bb~~~b~~~~b~~bbb~~~~b~~~b~~~~~~~b~b~b~~~b~~~bb~~~b~~~~~~~~~~~~b~~~~~~~~~~~~~b~~b~b~~~
bbb~~~~~~b~~~~~~~b~~~b~~~~~~b~~~~~~~~b~~~~~~b~b~~~~b~~~~b~b~b~~b~~b~b~~~~~~~~~bb~~~~~~~b~~~~~~~~b~~b~
b~~~~b~~~~~b~~~b~~b~~~~~~bb~~b~~~~~~~~~~b~~~~~~~~bb~~bb~~~~~b~~b~~bb~~~~b~~~~~~~~~b~~~~~~~~~~~~~~~~bb
~~~~~~~~~~bbb~b~~~~~bb~b~~~b~~b~~~b~bb~~~~~~~b~b~~~b~b~~~~bb~~b~~~bb~bbb~~~~b~~~~~~~~~~~~~~b~~~~~~b~~
