~~~~~~~~b~~b~~b~~b~~~~~~~~~~~~~~~b~~~~~~bb~b~b~~b~~bb~bb~~b~b~~~~~~b~~~b~b~~~~~~~~~b~~~b~~~bb~~~~~~~~
b~~b~~~bb~b~b~~bb~~~b~~~b~~b~b~~~~~~~~~b~~~~~~~~b~~~~~~~b~b~~~b~~bb~~~~~~bbb~b~~bb~~b~b~~~~~~~b~~~~bb
~~bb~~~~~~~~bb~~~~~~b~~bb~~~~b~~~b~~~~~~~~~~b~~~~bb~~b~~b~~~~~~~~~~~~b~~~~~~b~~b~~~~b~~~~~~~b~~bbb~~~
~~~~~~~~~~~~b~~~b~b~~~~b~~~bb~b~bb~~~bb~b~~~~~~b~~b~~~~~~~~~~~bbb~~~~b~~b~b~~bb~~b~~~b~b~bb~b~~~~~~~~
~~~~~~~~~b~~~b~bb~~~~~~~~~~~~~bb~~~~~~~b~b~~~~~~~b~~~~b~~~~b~~~~b~~~b~~~~~~~~~b~~~~~b~~b~~~~b~~~b~~~~
~~b~bb~~~bb~~bb~~~~b~bb~~bb~~bb~b~~~bbbbb~bb~bbbb~bb~~~~b~~bbb~~~b~~~~bb~~~~~b~~~~~~~~b~~b~b~~~~b~~~~
~~~~~~b~~~~b~~bbb~b~~~~b~~b~b~b~~~b~b~~~~~~bbb~~b~bb~~b~~~~b~~~~~b~b~~~b~b~~~~~~~~~~~~bb~~~~~~~~~~bb~
~b~~~b~~bb~b~~b~~~~b~~~~~~b~~bb~~~~~~~b~~~~~~~b~~b~~~b~~~~~~bb~b~b~~~~~~~~~~bb~~b~~b~~bbb~~~~~~~~~~~~
bb~b~~~~bb~~~~~~~b~b~~~~~~bbbbbb~~~bb~~~~~bbb~~b~~~b~~~bb~~~~~~~b~b~bbb~~~~~~~~~b~~~~b~~~b~~~b~~~~~b~
bb~b~~~~~b~b~~~~~~~~b~bb~~~~~~~~b~b~~bb~~~~bb~b~b~bb~~b~~~bb~bb~~b~~~~~~~~b~~~b~~~bb~b~~~bb~~b~~~~b~~
b~~~~b~~bb~~~~~~~b~~~~~~b~b~b~~~~~~b~~b~~~~~~~~~b~~b~~~~~~~~~~~~~~~~~b~~~~b~~~bbb~b~~bb~~~~~~~~~b~~~b
~bb~~~b~~~~~~b~~~~~~~~b~b~~~~~b~~b~~~b~b~~~b~~~~~bb~~~~b~~~~~~b~~bb~~~~~~b~~~b~~~~bb~b~bb~bb~b~~b~~b~
b~bb~~~b~~~b~~~~bbb~~~~~~~~~~~b~~~~~~~~~~bb~~~b~~~~~b~b~bb~~~~b~~~~~~~~b~~~~~b~b~~~~~~b~~~~~~bbb~~bb~
~bb~~~b~~~b~~b~~~b~~~~~~b~b~~bbb~~~~~~bb~~~~~~~bbb~b~~~~bb~b~b~~~~~~~~~~~~b~~~~~~b~b~~b~~~b~bb~b~~~~~
~~bb~~b~~~b~bb~~b~~~~~~~~~b~b~bb~~~~~~~~bb~~~~~~~bb~bb~bb~~~~bb~~~~b~b~b~~~~~b~~b~bbbb~~~b~~b~~b~~~~b
bb~~~~~~~~~~b~~b~b~~~~~b~~bb~~~~~~b~b~~~bbb~~~~~bb~bb~b~~~~~~~b~~~~~~~b~~~~~~bb~~bb~bb~~~b~~~~~bb~b~~
b~~~~b~~b~b~~~~b~~~b~~~~bbb~~~b~b~~bbb~~~~~~~~bb~~~~~~~~b~~~~b~b~b~~bb~bb~~bbb~bbb~b~~~~~b~b~~~~~b~~b
~~~~~~~~~~~~~bbbbbb~~b~~b~b~b~~~~~~b~~~~~~~b~~~~b~b~~~bbb~~~~bbb~~b~b~b~bbb~~~~~~bb~~~~~~~b~~~~~~~bb~
bb~~~~b~b~~bbb~bb~~~bb~~~b~b~~~~~~~~b~bbb~~bbb~~b~~~b~~~~~b~~b~~bb~~~~~~~~~~~bb~b~~b~bbbb~~b~b~~~~~bb
~~~~b~~~~bb~~bb~~~b~~~b~~bb~~~~b~~~~~b~b~~~bb~~~~b~~bbb~~bb~~b~~~~~~~b~~~~~b~~b~bb~~~~~b~~~~bb~b~~bb~
~~bb~~~~~~b~~~~~~~b~~b~~bb~~~~~bb~~~~~b~~~~~~~b~~b~b~~~bbbb~b~~~bb~b~~b~bbbb~~b~~~~~~~~~~~~~~~~~~~~~~
~~~~~~b~bb~b~bbb~~b~~~~~b~~~~~~~~~b~bb~~bbb~b~b~~b~b~~~bb~~b~b~~b~bb~~~~~~~~~b~~~~~~b~~~~~~~~~~~bbbbb
~b~~~~~~b~~~~~bb~~~~~bb~b~bbb~~~~bbbb~~bb~~~~b~b~b~~~~~b~~~~bb~~~b~~b~~~~~~~~b~~~~b~~~bb~b~b~~~~~~~~~
~~~bb~~~~~b~bb~bb~b~~~~~~~~~~bbbb~~~~~~~b~b~~bb~~bbb~b~~~b~~~~~~~~~b~~~~b~~~~~~~bb~~~~bb~~~~~b~b~~~b~
~~~~~bb~b~~~~~~~~~b~bb~bb~~~~~~~~bbb~~~bb~~~b~~~~b~b~~~~~~~~~b~~~bbb~b~~~~bb~~~~~~~~~~~~~b~~b~~b~b~~~
~~b~~b~~~bb~~~~b~~~~bb~b~~b~~~b~~b~bbb~b~~b~~b~~~~~~~~~bb~b~b~~~b~b~~~~b~~b~~~~~b~~~~~~~bbbb~~~~~~~~~
b~~~b~~~~~~~~~~~~b~bb~~~~b~~~~~~~b~b~~~b~bb~b~~~~~b~b~bbb~~~~~b~~~~bbbb~~~b~~~bb~~~~~bbb~~b~~~b~~~~~~
~~~~b~~~~~~b~~~bb~bbbb~bb~bb~~b~~~~~bb~b~~bb~~b~~b~~~~~bb~~b~~~~b~~~~b~~~~~~~~b~~b~b~~~~~~b~~~b~b~~b~
b~~~~~~~~~~~~b~b~~b~~~~~b~b~bb~~~~~~~~~~~~~~~b~~~b~~bb~~~~b~~~~~~~~b~~~~b~~~b~~~~~~~~~bbb~~b~~~~~~bb~
~~~~~bb~b~~b~bbbbbb~~~~~~~b~b~~~~~b~~~b~~~bb~bb~b~~~~bbb~~~bb~~~b~b~~~~b~b~~b~~~~bb~b~~~~~b~~bb~~~~~b
~~~~~~~b~~~~b~~~b~b~~~bb~~b~~b~~~~~~~b~~~~~~~b~bb~~~b~~~b~~~~~~~bbb~~b~~~b~~~~b~~~~~~~~~~bb~~~~~b~b~b
bb~~~~~b~~~~b~~b~bbbb~~~b~~~~~~b~bb~~b~b~~b~~~~~~~~~b~~~~~~b~~~~~bb~~~~~~b~b~~~~~~~~~~~bbb~~~~b~~bb~~
~b~~~~b~~~b~b~~~b~b~~~~~b~b~~~~~~~~~bb~~bb~~~~~b~~~~~~b~~~~~~~~~~b~~~b~~b~bb~~~b~~~~~~~~~b~~~bb~~~~~~
~~~b~~~~b~~~b~~b~b~b~bb~~b~~b~~bb~b~~~~~~~~b~b~~b~~~~~~b~b~~~~b~~~~~~~~~b~bbb~b~~~~~~b~~~b~bbb~~~~~~~
~~~~bb~bb~bb~~~~~~~~~~~b~~~~~~~~~~~bb~b~~b~~~~~~~~~~~~~b~~~bbb~~b~~~b~b~~b~~~~b~~~~b~~~bb~~~~~~~b~~~~
b~~~~bb~~~~~~~~b~~~~~bb~b~~~~~b~b~~~b~~b~b~~~~~~bb~~bbb~~~~~~~~~~b~b~~~~~~~~b~~b~~bb~~~~~~~~~b~b~~~~~
~b~b~~~~b~~~~~~~~b~~bb~b~bb~~b~~~b~~~~~b~~~~~~~b~~b~~~~b~b~~~b~~~~~b~~b~~~bbb~~~b~~~b~b~~~~b~~~~b~~~~
bb~b~~~~~~~b~~b~~~~~~~~~b~b~~bb~~bb~~~~~~b~bb~~~bb~~b~~b~~~b~~~b~~~~~bbb~~b~~~~b~b~~~~~bb~b~b~~~~~~~~
b~~~~~~b~~b~~~~b~~~b~~~~b~~b~~~~~~b~~b~~b~~b~b~~~~~~bbb~~~~~~~~b~b~~~~~~b~~~~~~~bb~~b~~b~~bb~~~~~b~~~
~~~~~~b~~~b~b~b~b~~b~~bbb~bb~b~~b~~~~bbb~~~b~~b~b~~~b~~b~~b~~~~bb~bb~~~~~b~~~~~~~b~~b~b~~~~b~~~~bbb~~
b~~~~~~bb~~bb~b~~~bb~b~b~~~bb~~b~~~bb~~~~~~b~b~~~~~~~~bb~~~~~b~~~~~b~~~~~b~~bb~~~~~~b~b~~b~~~~~bb~b~b
b~b~~~~~~~~~~~~~~bb~b~~bb~~~~~~~~b~~~~~~~~bb~~~bb~~b~~bb~b~~~bb~~b~~~b~b~~~~~~~~~~~~~~~~bbbbbb~~~b~~b
~~~b~~~b~~~~b~~~bb~~b~b~~b~b~~~b~~bb~~~bb~~~~~~bbbbb~~~bb~~~b~~bbbbb~~~~~~b~~~~~~~~bb~~~~~bb~b~~~~~~b
~~~b~~~~b~~~~~b~~b~~~~~b~~b~~~~~~~~~~~b~bbb~~~~~~~~b~~~b~b~~b~~~~~b~~~b~~~~b~~~~b~b~~~~~b~b~~b~bb~~~~
~b~~~~~b~~~~~~~bbb~~~~~~~b~~~~b~b~~b~~~~~~bb~~b~~~~~~~~~bb~~~~b~~~b~~bbb~~bb~~~~bb~~~bb~b~~bb~~b~~~~~
b~~~~~~~b~~~~b~~~~~~b~~~~b~~b~~~~~~~b~b~b~~~~~bb~~~b~b~b~bb~b~~~b~b~~~~~~b~~~b~~b~~~~~~~~~~~~~~~~~~~~
b~bb~~~~~~~b~~~~~~bb~bb~~~~~~~~~~~~~~b~~~~b~~bb~~~b~~~bbbb~~bbbb~bb~bb~~~~~b~~~b~~b~~~b~bbb~bbb~b~~~~
~~~~~b~~~~~~~~~bb~~~~~~b~~~b~~~b~~b~~bb~~~~~~~b~~bb~bbb~~~~~~~bb~~~~~~~~bb~b~b~~~~~~~~~b~~~b~~~b~~~bb
~~~b~~~~~~~bb~~~~b~bb~~bb~~~~~~~~b~b~bbbb~~b~~~~~b~~b~~~~bb~~b~b~~~~b~b~~~b~~b~b~b~~~b~b~~b~~~~~b~b~~
~~~~~~bb~~~b~~~~~~b~~~~~~b~~~b~~~~~~~b~~~~b~~bb~b~~bb~~~~~b~~~~~~~b~b~~~~~bb~~~~bb~~bb~b~~~~~~~~~~~~b
b~G~b~bb~~b~~bb~b~~bb~~~~bb~~~~b~~~~~~~~~b~~~~b~~~~~~~~~bbb~~b~~bb~b~~~~~b~~~~bb~b~bb~~~~~~~~~~~~b~~~
~b~bb~~~b~~~~~b~~~~~~~bbbbb~~b~~~~b~~~~~~~b~~~~b~~~~~~~b~~bbbbbb~~~~~~~bb~~~b~b~~b~~~b~~~bbb~~~b~~~~~
~b~b~~~b~bb~~~bb~~~b~~b~bb~~b~~~~b~b~~~~b~~~~~~~~~b~~~b~~~~~~~~~~b~b~bb~~bb~bb~bbb~b~~~~~bb~~~~b~bb~~
~~b~b~~~bb~~~~~bbb~~~~~~b~~b~bb~bbbb~~~~~~~~b~b~~b~b~~~~~b~b~~~b~~~~~~~bb~~~~~~~~~~~~b~b~~~~b~~~~~b~~
~~b~b~~~~~~b~bb~~~~b~bb~bbb~~~bb~~~~bbb~b~b~~~bb~bb~~~~~~~~~~b~~bb~~~~~~~~bb~~~~~~~~~b~~~~~~~~~b~~~b~
b~~b~b~~bbb~b~~~b~b~~~b~b~~~~~~~~~~~b~~~b~b~~~~~~~b~~~~~~~~b~~~~b~~~~~~~~b~~b~~~~~~~~~~~b~~~b~~b~~~b~
~~~~~bbb~~~~~~~~bb~~~~~~~~~b~~~bbbbb~~~~~~~~b~~b~b~~b~~~~bb~~~~~~~~b~bb~~b~bb~~~~b~~~~b~~~~~b~~bb~~~~
~bbb~~~~~~bb~~~~~~~~~~~~~~~~~~~~~b~b~~~~~b~~~~~~bb~~~~~bb~~~b~bb~~~bb~~~b~~~~~b~~~~b~b~~~b~~b~~b~~~b~
~~~~~~b~~~~~~bb~~~~~~~~bb~b~bb~~~~bb~~~~b~~~~~~~~~~~~b~~~~~b~~~~b~b~bb~b~~b~~~b~b~~~~~~~~~b~~b~bb~bb~
b~~~~b~b~~~~b~~b~b~~~~b~b~b~b~~~~~~bb~~~~~b~~~b~b~~bbb~~~~~~~~~~b~~~~~~~bb~b~~~~~~b~~~b~b~~~~~~~b~bb~
~~b~~~~~~~~~~bb~~b~~~~~~~~~~~~b~~~~b~b~bb~b~bb~~b~~~bb~bbb~~~b~~~~~b~b~bb~b~bbb~b~~b~~~~b~~b~~~~~~~b~
bb~b~~b~~b~bbb~~b~~~~~~~~~~bb~~~~~~~~~~~b~~bb~~~~~~b~~~~b~b~~b~~~bb~~~~~b~~bbbbb~~bb~~~~~~~~~b~~~b~~~
~~~~~b~b~~b~~~~~~~b~~bbbb~~~bbb~~bbbbb~~~~bb~~~~b~~~b~~~~~~~~b~~bb~~~~~~b~~~bbb~b~~~~~~~~b~~~~~b~~~~b
~~~bb~~~~~~bb~b~bb~~~~b~~b~~~~~~~~b~~~b~~~~~~b~~~b~~~~~b~~~~~b~b~~~~~b~~b~~~~b~~~~~~b~b~b~~b~bb~b~bbb
b~~b~~~~~bb~~~~~b~b~~bb~b~b~~~~b~~~~~~b~~~~b~~~~b~bb~b~~b~bb~~~~~~~~~~~~~~~~~~~~b~b~~~~~~~bb~~~~~bb~~
~~~b~~~bb~b~b~b~~b~~~b~~~~~b~~~b~b~~~bb~~bb~~~~~~b~~~b~~~b~~b~~~~bbb~~b~~~~~~b~~~~~~~~~~~~b~~~~~~b~~~
~b~bbb~~~~bb~~~~b~~~b~~bb~~b~b~~~b~~~~~b~~~~~bb~~~bbb~~~b~b~bb~~b~~b~b~~~~b~bb~~b~~~~~~~~~~b~b~bb~bb~
~~~bbbb~~~~~b~~~b~~bb~b~~b~bb~~~~~~b~~b~~b~~~~b~bb~~~~~~b~~~b~~~b~b~~b~~b~~~~~b~b~~~~~bbbbb~~~b~~~~~~
~~~~b~bbb~~~~~~~~b~~~bb~~bb~~~~bb~~~~~~~~~~~~~~~~~bb~~~~~~~~b~~b~~~bb~b~~~bb~~b~b~b~~~b~~~bb~b~~~~b~~
~~~b~~~~b~~~~~~~~~bbb~~~~~~~~~~b~~~~~~~~~~~~b~b~b~~b~b~~~b~~~~~~~~~~~b~~~~~bb~~bb~b~~~~~b~b~~~~~~b~~~
~bb~bb~~b~b~bbbbb~~~~~b~~~~~~~~b~bbbb~bb~~~~bb~~~~~~bb~~~~~b~~b~b~~~~b~~b~b~bb~b~~~~~b~~~~b~~b~~bbbb~
~~b~~~b~bb~~~~b~bb~~b~b~~~~~~b~~~~~~~bb~~~~~~b~~~~~~b~~b~~~~~~~~~bb~bbbb~~~~~~~~~~b~~~~~~~~b~~~~~bb~~
b~~~~b~~~~~~b~b~~~~~~~~b~~bb~bb~bb~b~b~~~~~~~~~~bb~~~~~bb~~~~~~b~~~~~~~b~b~~~~~~~~~bbb~~~~~~~~b~~~~~~
~b~~b~~b~b~b~~~~~~~b~~~~b~~~b~~b~~~~bbb~~~b~~b~b~b~~~~bb~~~b~~~b~~~~b~~b~bb~~~~~~b~bb~~b~~~~~~~~~~b~~
~~~b~b~~~~~~~~~bb~b~~bb~b~~b~bb~~~~~~~~~b~b~~~~b~~~~~b~~b~b~~b~~~b~~~~bb~~bb~b~b~~bbb~~b~~b~b~~bb~~b~
b~~b~~b~~~~~bbb~~~b~~~~~b~b~~~b~~~~bbb~~~b~~~~~~~~~bbb~~b~b~~~b~~b~~~~~b~~~b~~b~~bb~~~~~~~bb~b~b~~~b~
b~~~b~~b~~~~~~~~~~~bb~~~~b~bbb~b~b~~bb~~~~~~~~~~~~~~~~~b~~~~~~~~~~~b~~~~~~~~bb~b~~b~~~~b~~~~~~b~~~~~~
~~~~~~~~~~bb~~~b~bb~~~~~~~~bbb~~~~~~~~~~b~~~~~~~~~~b~~~~b~~b~b~b~b~~~~bbb~b~b~~~~~~~~~b~b~b~~bb~~bb~~
b~~~bb~~b~~~~~bb~bb~b~b~~~~b~~b~~~~~bb~~~b~bb~~~b~~~~~b~~b~~~~~~b~~~~~~b~~~~~b~b~~b~~b~~b~~~b~~b~b~~b
~~b~~~~bb~~~b~~b~b~~~~b~~b~~~~~bb~b~b~~~~~~~~~~b~~~~~~~~bb~~~b~b~b~bb~b~~~~b~b~~~b~~~~b~~~bb~b~~bb~~b
~~~b~~~~bbb~~~b~~bbb~bb~~~~~~~~~~~b~~~~~bbb~~~~b~~~b~~b~bb~b~~~~~~~b~~b~~b~~~~~~~b~~~~b~~~~~~~~~~~~~b
~b~~~~~bb~~~b~~~bbb~b~~~~~~b~b~~~bb~b~~~~~~~b~b~~~b~~~~~~~~~~b~~~bb~~b~~~~~~~b~b~bb~~~b~~~~~~~~~~b~~b
~b~b~~~~~~b~~~~b~bb~~~b~~~~~~~bbb~~~~~~~~~~~~~bb~~~b~~~~~~~b~~~~~~bb~bb~~~b~bb~~~~~~b~~b~~bbb~~~~b~bb
~~~b~~~~~~~~~~~~~bb~~~bbb~~~~~b~~~~~b~~~~~bb~~~b~~b~b~b~~~b~~b~~~~b~bb~~~~b~~b~~bb~~~bbb~~~b~~~b~~~~b
~b~~b~bb~~~~~~~~~~~bb~~~~~~b~bb~~b~~~b~b~~~~~b~b~~b~bb~~~~~~~b~~b~~bbb~bbb~~~~bb~~~~~bb~b~~~b~b~~b~b~
~~~~b~~~~~bb~~b~bbbbb~b~~~b~~~~~~b~~bbb~bb~~bbb~~b~~~~~~~~~~b~~b~~bb~~~~b~~~~~~b~~~~b~~~~~~~~~~~~~b~b
~~~~~~b~bb~~bb~~~~~~b~~~bbb~~~b~~~~~~~bbbb~~~~~b~~~~~~~b~~b~b~~~~b~b~b~~b~b~~~~b~~~~~~~~bb~~b~b~b~~~~
~~~b~b~~b~~~~~bb~~b~~~~bbb~b~bbbbb~~~~~~~bb~~~~~~~~b~~~~~b~~~~~b~~~b~~~b~b~~~b~~~~~~~~~~~~~bb~~b~~b~b
b~~b~bbb~bb~~~~~~~~~b~~~~bb~~~b~~~~~~~~~b~b~~~bbbb~~bb~b~~bbb~~~~~~~b~~bb~~~~~~b~b~~~~b~~b~~~~~~~bb~~
~bbbb~~~~b~~bb~~b~b~~b~~~~~~~~~~~~~~~~~~~~bb~~~~b~~~~bb~~~~~~~~~b~~~~b~b~~~~~bbb~~~~~~~~~b~~~~~b~bb~~
~~b~~~~b~~~~~~bb~~bbb~~~bbb~~bb~~~bb~b~~b~~bbb~~~~~~b~~~bb~b~~~b~~bbb~~~~~~~~~~bb~~~~~~~~~~~~~~~~b~~~
~~~~~~~~~~~~b~~b~b~~~~~~~~b~bb~~~~~~~~~~bbbb~bb~~b~~b~~~~~~~~~~~~~~~~~~~~~~b~~~~~~~~~~~b~bb~b~~b~~bb~
~b~~b~~b~~~~~~~b~~~bb~~b~b~~b~bbb~~~~bbb~~~~~~b~~b~~b~~bbb~~b~~~~bbb~~b~~~~~b~~~~bb~~~~~b~~~~bb~~~~bb
~~~~~~~~b~~bb~b~b~~~~bbb~~~~~~~~bbb~~b~~bb~~b~b~~~b~b~~b~~b~~~~b~~b~~~~bbbb~~~~~~~~~~bbb~bb~~~b~b~~~~
~~bb~~~~~~~b~~~~~~b~~~~b~bbb~~~~~b~~~~b~~b~~~b~~bb~~b~~~~bb~~~~~~~~~~b~~~b~~~~~~~~bb~~b~~~~b~~bbbb~~~
~~b~~~~~~~~~~b~~~~b~~~~~~~~~~b~~b~~bb~~~~~b~b~~~b~~~~~b~~b~~~bb~~b~~~~~~~~b~b~b~~b~~~b~S~b~~~b~~b~~~b
~~~~b~bb~~~~b~~~~b~~~~b~~~~~~~~~bb~~~b~~~~~~b~~~~~b~~~~~~~b~bb~~~~~~~~~bbbb~~~~~~~~~~~bb~~~~~b~~~~~~~
b~~b~b~~~bb~b~~bb~b~bb~~~b~~~~b~~~~b~bb~bb~bb~bb~b~~b~~b~~~b~~b~~~~~b~~~bb~b~~~~bb~bb~~~bb~~~~bb~~~~b
~~b~~~~~bbb~bb~~~bb~~b~~~~~~~b~~b~~~~~~bb~~~~~~b~b~~~b~~~~b~~~b~b~~b~~~~b~~~~~~~b~~~bb~b~~b~~~~~~~~~b
~b~~b~~b~b~~~~~~~b~~b~~~~~~b~bb~~~b~~~b~~~~~~b~~b~bb~~b~~b~~~~~~~~b~~b~bb~b~~~~~~~~~b~~~b~~~~b~~~b~b~
b~~~~~~~~~~~b~~~b~~b~b~bb~b~~~~~~~~bb~b~b~~b~~bb~~~~b~~~~~bb~~~b~~b~~~bb~~b~b~~b~~~~bb~~~~b~b~bbbb~~b
