~b~~b~~~~~~~b~b~~~~~~bb~b~b~~b~bbbbbb~b~b~b~~~~~~~~b~~~~b~bb~~bbbbb~b~~~b~~bb~bb~~~bb~~b~~~~~~b~b~~~~
~~b~~~b~~~~b~~~~~b~~~bb~~~bbb~~~~~bbbbb~~~~~~~~~~b~~~b~b~b~~~~~b~b~~bb~b~~~bb~~~~~~~~~~~bb~~~b~~~~~b~
bb~~~bb~bb~~~b~b~~~~b~~~~~bb~b~~~~b~~~bb~b~~~~b~b~b~~~b~b~~b~b~~~bb~b~~~~~bb~~~~b~~~~~b~b~~b~b~~~~~~~
~b~bbb~~~b~bb~~b~~b~~~b~bb~~~~~bb~~b~b~~~bb~~b~b~~~~~~b~b~~~~~~~~~b~b~b~~~b~~bbb~bbb~~~~~~~~~~~b~~b~b
b~~b~b~~~b~~~~~~~~b~~~~~~bb~~~~~~bbb~~~bb~b~~~b~~~~b~~b~~~~~b~~~~bb~~b~b~~~~b~~~~~b~b~~~b~~~~~~~bbb~~
~~~~~~~~~b~b~b~~bbb~b~~~~~~~b~~~~b~~~~bb~~~~~~b~b~b~b~~~bb~~~~b~~bb~~b~~~b~~~~bbb~b~~b~~~b~b~~bb~~~~~
~~b~~b~b~b~b~~~~~~b~bb~~b~~~~~~~~~~~~bbb~~~~~~~~bb~~~~~b~~b~~bb~~~bb~~b~~~~~~b~~~b~~~~~~~bb~b~~~~~~~~
b~~~b~~b~~~~~bb~~~~b~~~~~~~b~b~~~b~~~~bbb~b~~~~~~~~b~~~~~~~~~~~b~~~~~~~~~~~~~~~~~~~b~bb~bb~b~~b~~b~~b
~b~~~~~~~b~~~~~~~~bbb~~~~bb~~bbb~~~~bb~~~~b~~b~~~~~bb~~b~~~~b~~b~~b~~~~~~~~~b~~~~b~~bbb~~~~bb~~b~~b~b
~~bb~b~~b~~bb~bb~b~~~~~~~~~bb~~~~b~~~~bb~b~b~~~~~b~~~~b~b~~~~~~~~~bb~~b~~b~~~~~b~bb~~bb~~b~~~~~bb~~~b
~~b~~~~b~~b~b~~~~b~~~bb~~~~~~~bb~~b~~~~~~~b~b~~~~~~~~~~b~~~~~~~~~~b~~~~~~bb~~b~~b~~bb~~~b~~~~bb~~~bbb
~~b~~~~b~~~~~~~~~~~b~~b~~b~~~~~~~~~b~~~~~~~~~~~~~~bbb~~~b~~b~~b~~b~~b~b~~~b~~~~b~~~~~~~b~~~b~~~~~~~b~
~b~~b~bb~~b~b~~b~~~b~~~~~~bb~~~b~~b~~~b~~~bb~~~~~bb~~b~~~~b~~~~~~~~~bb~bb~~~~bb~~b~~~b~~~~~b~~~~b~b~~
~~~~~~~~~~~~b~~~~~~~bb~~~~~~~~~~b~~b~bb~b~~~~~~b~~~b~bb~~~b~bbb~b~bb~bbb~b~~~b~~~b~~~b~b~~~b~~~~b~~~~
~~~b~~b~~bb~~~~~b~b~~b~~b~~b~b~~~b~b~~~~b~b~b~~b~bb~~b~~bbb~~~~~~~~~b~~~~~~b~~~b~b~~b~~~bbbb~~~~b~bb~
~~~~~~~~~b~~~~~~~~bb~~~~~~b~~~b~~~~b~bb~b~~~bb~b~~~b~~b~~~~~~~~b~~~~~~~b~~~~~bbb~b~~~b~~~bb~~~bb~~~~b
~b~b~~b~~~~b~~bb~~bb~~~~~~b~b~~b~~~~b~~~~~b~~~b~~b~~b~~~~~~~b~bb~~~~bb~~~~~~~~~~~~b~~~~~~~~~~~bb~~~~~
~~bb~~b~~b~~~~~~~~b~~~b~b~~b~~~~b~~~b~~b~bbb~~~~~bb~~b~~~~bbb~b~~~b~b~~~~~b~~~~bbb~~b~b~~bbb~~bb~~~~~
~b~~~~~~~b~~~~~b~b~~b~b~b~~~~~~b~b~~~~~~~b~~~bb~~~~~~b~b~~b~~b~~~~b~~~~b~~~~~b~~bb~~~~~bb~~~b~~b~bbb~
~~~b~~~~~b~b~~~~b~~~b~bb~~b~b~b~~~bbb~~bbb~b~~b~b~~~~~~~~~~~~~b~~b~~~~bb~b~~~~~~~~~~~~b~~bbb~b~~bbb~b
~b~~~~b~~~bb~~~~~b~~~~b~b~~~~~~b~bb~~~~b~~~~~~~bb~bb~~~b~~~~~bb~~b~bb~~~~~~~~~~~~~~~bbb~~bbbb~b~~b~~b
b~~~~~~~bb~~~~b~~~~~~bb~b~bb~~~~~~bb~~~~~~~~~bb~~bb~~b~b~b~bb~~bb~~~~~b~~b~b~~~~~~b~~~bb~~~~bbbb~~b~~
~~~~~~~~~~~~~b~~~b~~~b~b~~~b~b~~~~b~~~~~~b~~~~~~~~~~b~~b~~~~~~b~~~b~~~~~~~~~~~b~~~bb~b~~~~b~b~~~~b~b~
~~~~~~~b~~~~b~~~~~b~bb~~~~~~~~~~~~~b~~~bb~~b~~~b~~~~~bbb~~~bbbb~~~b~~~~~~~~~bb~b~~~~b~b~b~b~~~~~~b~~~
b~~b~~~~b~~b~b~~~bb~~~~~~b~~~~~~~b~~b~~~~~~~~~b~~~b~~b~b~~~~b~~~b~~~~~~~~~~b~~bb~~~~bb~~~~b~~~~~b~~b~
~~b~~~b~~~~~~~~b~~~~~~b~bbb~~~~~~~~~b~~~~bb~~~~~~b~b~~~~~~~b~~~b~b~~~b~~~~~~~bb~~~b~bb~~b~~b~b~~b~~~~
b~~bb~~~b~~~~~~b~b~~~~~~b~~~~bb~~~~~~~~~~b~~~~~~~~~~~bb~~bb~b~b~~bbb~b~b~~~~~~~~~~~~b~~~~~~~b~~b~~~~~
~~~b~~~~~~~~~~~~~~~~~b~b~b~~~~~~~~~bbb~~~~bb~bbb~bb~~~~~bbb~~~~b~~~~~b~~~~bbb~b~b~~~b~b~~b~b~bb~~~b~b
b~~b~~b~~~~~~~~~~~~~~~b~~~~~~b~b~b~~~~b~~~~~b~b~~~~bb~b~bb~bb~~~~b~bb~b~~~~~b~~~bb~~~~bb~~~b~~~~b~bb~
~~~~~~~~b~~b~b~b~~~b~~~~~~~~bb~b~b~b~Sb~~~~b~~b~~~b~b~bb~b~~~~b~~~~~~b~~~b~~b~~~~~~~~~~bb~~~b~b~b~~b~
~~bb~~~b~~b~~~~bb~bb~~~~~~b~b~~~~~b~b~~~~bb~b~~~~~~~b~~b~~~~b~~~~~~b~bb~~~~~~b~~~bb~~b~b~~~~~b~~b~~b~
~~~~~bb~~bb~b~~~~~b~~~~b~b~~~~~~~~b~~~~b~~~~~b~b~bb~~~~~b~~~~b~b~~~~~~~b~~b~b~~~~b~~~~b~bb~~~~~~~~~~~
~b~~b~~bb~~~~~bb~~~~b~~~bb~~b~~bbb~~b~b~b~b~~b~~~~~b~~~b~~~~~b~~~b~~~~~~~b~~~~~~~bb~~~b~b~bb~b~~~~~~~
~~~~~~b~~~~~b~b~b~~~~bb~b~~~b~~b~~b~~~~~~~~~~~~~~b~~b~b~bb~~~~b~bbbb~bbb~~~~~~~~b~~b~b~~~~~~b~bb~~b~~
~b~b~~~b~b~~~b~~~~~b~~~bb~~~~~b~~~~~~~~~bb~~bbb~~bb~~b~~~~~b~~~~~b~~b~~b~~~~~~~b~~~~~b~~b~bb~~~~~~~~~
~~~~~bb~b~~~~b~~b~~~b~b~~~~~~b~~~~~~b~~b~b~~~~b~~~~~~~b~~~b~~~b~~~~~~~~~~bb~~~~~~~~~~b~bb~b~~~bb~b~bb
~bb~~~~~~~~bb~bb~bb~~~~b~~bbbbb~~~~~~~~~~~b~b~~~bb~~b~~bb~~~~~~~b~~~~~~~~~b~~~~~b~~~bbbbb~b~~~~~~bb~~
b~~b~~~b~~b~~~~~~~~~~~~~bb~~~~b~b~~~~~~~b~~~b~b~~b~~~~~~~b~~~b~b~b~b~b~bb~~~~~~b~~~~~~~~~~b~~b~~~~b~~
~~~b~~~b~~b~~b~~~~~~~~~~~~~bb~~~~bb~~~~~~~~b~~~~b~bbb~~~~~~b~~~~~~bbbb~~~~~~~~~b~~~bb~~b~b~~~b~~~bbbb
~b~~~~~~bb~b~~~~~~~b~~~~~bb~b~~~~~~~b~~~~bb~~~b~~~~~~~~~~~b~b~~~~~~b~~~~~~~bb~b~b~~b~~~~~~~b~~~~bbb~~
bbb~~b~b~b~b~~~b~~~b~~b~~b~bb~~b~~~b~~~~~~~~~~~~~b~~~~~~bbb~~~b~~b~~~b~~~~~~b~~~~bb~bb~~~b~~~bbb~~~b~
~~b~~~~b~~~bbb~b~b~~b~b~b~~~bb~~b~~~b~b~~b~~b~~~b~~bb~~~~~~~~~~~~b~~~~b~b~~~~~bb~b~~~~b~~~b~~~b~~~~~~
~b~b~b~~~~~~~~~~b~b~~~~~~~b~b~b~~~b~~~~~~~~~~~b~b~~~~~~b~~~~~~~b~~~bb~bb~b~~~~b~b~~~~~~~b~~bb~~b~~b~~
bb~b~~~~~~b~~~~~~~~~~~~~~~~~bb~~~~b~~~~~~b~b~bb~~b~bb~~~~b~b~~~bb~~~~~~~~b~~~b~b~b~~~b~~~bb~b~~~bb~b~
~~b~~b~b~~~b~~~~~bb~~bbbb~~~b~~b~~~~~~b~b~bbb~b~~~b~~~~bbb~~b~bbbb~~b~~~~~~~b~~b~~~~~~~~~~~~~~b~~~b~b
b~b~bb~b~b~~~b~~~b~~~~~~~b~~b~~b~bb~bb~~~bbb~~~~b~b~~~b~b~~b~b~~b~~~bb~~~bb~b~~b~b~~~~b~~~bb~b~~b~~b~
b~b~~~b~bb~~~~~bbb~b~b~b~~~~~~~b~~~b~~~~~b~~~~~~~~~~~~~~~~b~bbb~~b~~~~b~~~b~~~b~~~~~bbb~b~~b~~~~~~~bb
b~~~~~b~~~~~b~~b~b~~~~b~~~~b~~b~b~~~bb~b~b~~~~bbb~~b~~~~b~~~~b~~b~~~bbb~~~b~~~~b~~~~~~~~b~~bbb~~~~~b~
~bb~b~~b~~~~~~bb~~b~~~b~~~~b~b~b~~~~~~bb~~~~bb~bb~~~bb~~~b~~b~~~b~~~~b~~~~~~~b~~b~~b~~~b~~~~~~~~~~~~b
~~~~bbb~~~~b~b~~~~bbb~bb~~~~~~~~~bb~b~~bb~~b~~~~~b~bb~~b~b~b~~~b~bbb~~~~b~~b~~~b~~bb~bb~~~~~~~~b~~~~~
~bb~~b~~bb~~~~~~~bb~~~~~bb~~~b~~~~b~~~b~bb~b~b~~~~~b~~bb~~~b~bb~~~~bb~~~~~~b~bb~~b~b~~b~~b~~~bb~~~~b~
b~~~b~b~b~~~~~~~~b~b~b~bb~~b~~b~~bbbbb~bbbbb~~bb~bb~~~b~~~~~~b~~b~b~~~~~~b~~~~~b~~~~~~~~bbb~~~~~bbb~b
~b~~~~~~~~~b~~~~~~b~~b~b~~~~b~~~~b~~~b~~~bb~~~~~~~~~~bbbb~~~b~b~~~~~~~b~b~~b~~b~~~b~~bb~~bbb~~~bb~~~b
~~b~~~~~b~b~b~~bb~~bb~~b~~bb~bb~~b~~~~~~~~~b~~~~~~~~~~~~~~b~~~b~b~bb~~~~~bb~~~bb~~~~~b~~~~~~b~~bbbb~~
~b~~bbb~b~bbb~~~~~~~~bb~~~~~b~~~b~b~~~~~~~b~~~~~~~~~b~b~~~~~~~~~b~~~~~~~~~b~~b~bb~~~b~~~~~~~~b~~~b~b~
~b~~~~~~~~~~b~b~~b~~~b~~~~~~b~~~~b~~bbbb~bb~bb~~~~b~b~~~~b~b~b~b~~~~~~b~~~~~~~bb~~b~~bbb~bbb~~~~~b~~~
~~~b~~~bb~~~~~~b~~b~~b~~bbbb~b~~~b~b~~b~~~b~~~~b~b~~bb~~~~~~b~~~~b~b~b~~~~~~~b~~bb~b~~bbb~b~b~~~~~b~~
~~~~~~b~~~~~b~b~~~bb~~~~b~b~~b~~~~b~~~~~~~bb~~~~~~b~bb~~b~~~~~~~~~bbb~~b~~~~~~~bb~~~~~~~b~~b~bb~~~~~b
~~b~~bb~~bbb~~~bb~b~b~~~b~~bb~~~~~~bb~~~~~~~~~~~bbb~~~~b~~~~~~b~~~b~~~~~bbb~b~b~b~~~b~bbb~b~b~~~~~~~~
~~b~b~bb~b~~b~~b~~~b~b~~~b~~~b~~~~~~~~~~b~~b~~b~~~~~bb~b~b~b~~~~~~~b~~b~b~~b~~~~b~bb~~~~b~~~b~b~~~bbb
b~~~bb~b~~~bb~~~bb~~~bbb~b~~b~~~~~~bbb~~b~~~b~~b~~b~~b~~~b~~~~bb~b~b~~~~b~~~~b~~~~b~~~b~~bb~~~~~~~~~~
b~~bb~~~~~b~~~bb~~~~~~b~bb~b~~~~~~~~b~~~~~~~~~b~~b~~~b~b~b~~b~~~bb~~~~b~~bb~~~~~b~~b~~~b~~~~~~b~bbbb~
~b~~b~bb~~b~~~~b~~~bbb~~~b~~~~~b~~~~~bb~bb~~~b~b~b~~~b~~~~~~b~b~~~b~~bb~~~~~b~~~~~b~~~~~~bb~~~bb~~~~b
~b~bb~~b~bb~~~b~~~bb~b~~bb~~b~bb~~~~~~~bbbb~~bbb~~~b~b~b~~~~~~~~~~~~~~~bbbb~~~~~bb~~~bb~b~bb~b~~b~~bb
bb~~b~~~~~~~b~~~~~~~~~~b~b~b~bb~~~~~~~b~~b~b~~~b~~~~b~~b~~~b~~~~~bb~b~~~~~~~~~~bb~~~~b~~~b~~~~~~~b~~~
b~~~~~~~~~~~~b~~~~~b~~b~~~b~b~~~~b~b~~~~~~~~b~b~~~~~~bb~b~b~~~~b~~~~b~~b~b~~~~~~~~~~bb~~b~~b~b~~~~~~~
b~~~~~~~b~bb~~b~~~~~b~~~~~b~~b~b~~bb~~~~~~~b~~~~~~~b~b~~b~b~~b~bb~~~b~b~~~~b~~~~~~bbb~~b~b~~~~b~~bbb~
~~~b~~b~~~~~~b~b~~~~b~bbb~~~~~~bb~~~~~~bb~~~~~~~~~~b~~b~b~bb~~~b~~~~~~b~~bb~~~~~~~bb~~~b~b~~~~~~~~b~~
~b~~~~~~~~~~~bbb~~~~bbb~~~~~~b~~~~~~~~bb~~~~~~~~~~~~bbb~b~~~~b~~~b~~~~~~~b~b~~b~~~b~~b~~~~b~~bbbb~bb~
~b~~b~~~~~~~b~~~~~~b~~bb~~b~~~~~b~~~b~~b~~bb~b~~~~b~bbbbb~b~~~~~~b~~~~~b~~~~b~~~~~~~~~~~b~bbbb~~~b~~~
~~~~bb~~~~b~b~~~b~b~~~~~~b~~~~b~~~bb~~~~~b~~bbb~~~bb~~~bbb~~~b~~b~~~~~~~~~b~~~b~b~~b~~b~b~~~b~~~~b~~~
~~~~~~bbb~bbb~~~~~bb~~~~~~~~bb~bbbb~~~~b~b~~~~~~~~~~bb~~~~b~~~~~b~~~b~b~~~b~~~~~b~bb~~~~~~~~~b~~~bbb~
~~bbb~~~~~~~~~b~~~~b~b~~~~~~b~bb~~~b~b~~bb~~b~~~bbb~~~~~~~~b~~~b~~~~~~~~bb~~b~~~~~b~~~~bb~~b~b~~~~b~~
~~~bb~~~bb~~~bb~b~~~~~~~~~~~b~~bb~b~~~~b~b~~b~~b~~~~~b~~~~~~~~~~b~~b~~b~~~~~~bb~~bb~~~~bbbb~~b~b~b~~~
~~~b~~~~~~~bb~~~~~bb~~~bb~bb~~bbbb~b~~b~~~bbbb~~bb~~~~b~~~~~~~~b~~~~~~~b~~bb~~~~~~b~~~b~~bbb~~~~b~~b~
b~~~~b~~~bbb~~b~~~~~bb~~bbb~b~~~~~b~~b~~~~~b~~~b~~~b~b~~~~~bbbb~~~~~~~~~~~~b~bb~bb~~~~bb~~~~bb~b~bbb~
b~~~~~~~b~~b~bb~~~~~~~bbb~bb~~~b~~b~~b~~~bb~b~~~~~b~~~b~~~~~b~~~~~bbb~~~~~bb~b~b~~~bb~~~~b~~~~b~~~b~~
bbb~b~b~~~~~~~~b~~~~~~~~~~bb~~~~b~~~~~~~bb~b~~~~~~~~bb~b~b~~~~~~~~bb~~b~~~~bb~b~~b~~b~bbb~b~~~b~~~~~~
~~b~~b~b~~~~b~~~~~b~~~~~~b~~b~~~~~b~~~b~~~~~~~~~~~~~~b~bb~~bb~~b~b~~~~b~~b~~~~b~~~~~~~~bb~b~b~~~b~~~~
~~~~~b~b~~b~~b~b~~b~bb~b~~~~~b~b~~~~~~~~b~~~~~b~~~~~~~~~~b~b~b~~bb~b~~b~bb~b~bb~~~~b~~~~~~b~bbbb~~b~~
~b~~~b~~~~~~b~b~~G~~~~bbb~~~~bb~~~bb~b~~~~~~b~b~~bb~b~~~~~~b~b~~~b~b~~bb~~~~~b~~~~~~~b~~b~~~~~~bb~~~~
~~~~~~~~~~bb~~~bbb~~~~~b~~~b~~~~~~~b~~~~~b~~~b~~~~~~~~~~~~~b~~~~~bbb~~~~~~b~bbb~b~~~b~b~~b~~b~bb~bb~b
~b~~~~b~~~b~~~~~b~b~b~b~b~~b~~~~~~~~bb~b~~~~b~~~~~b~~~~b~~b~~~bbb~~~~~b~~~bb~bb~~~bb~~~~b~b~~~b~~b~~~
~~~b~~bb~~~~b~~~~~~~~b~b~~~~b~~b~~~~~~~b~~~~~b~~~~~b~~b~~b~~~b~~bbb~b~~~~~~~bb~~b~b~~~b~~~~~~b~bb~~~~
~b~~b~~~~~~~bb~~~b~~~~~~~~~~b~~b~~b~bb~~~b~~~bb~~~~~~~~bb~~~~b~bb~~~b~b~~~~bbbb~~~~~~bb~b~b~~~~~b~~~~
~b~bb~~~b~~~bb~~~~~b~~bbb~bb~~b~~bb~~~~bbb~~~~~~b~~b~~~~~b~~~~~b~~~~b~~~~~b~~~b~b~~~~~b~~b~~b~b~b~b~b
~b~~~~b~~bb~~~bb~~b~b~bb~~bb~~~~~b~b~~~b~~b~~~~b~b~b~b~bb~~b~b~~~~~~b~~bbb~~b~~~~b~~~b~~~~~~~~~~~~~~~
~b~~b~b~~~b~~~~~~~~~~~~~~b~~~~~~~~~b~~~b~b~b~b~~b~~b~~~~~~~~~b~~~~~~b~~b~~~b~~b~bb~~~~~~~~bb~~~~~~~~b
~~~b~~~~b~~~~~~~~~~~~b~~~~~~b~~b~bbb~~b~~~~~~~b~b~~~~bbb~~~~~~~~b~bb~~~~~~b~~bb~bb~~b~~~~~~~~~~b~~~~~
~b~bb~b~b~~~~~~b~~~~b~b~~~~bb~~~b~~~~bb~b~~bbb~bb~~~~~bbbb~~~~b~~~~~~~~~b~b~bb~b~~b~~~bb~~~~~~b~~~~~~
b~b~~~b~b~~~~~~b~~~b~~b~~~~~b~~~b~~~b~~~~~b~~b~~~~~~b~~b~~~~b~b~~bb~~~~~b~~~~~~~~bb~~b~~b~~~~~~~~~~~~
~~~~b~~~~~~~~~~b~~b~b~bb~~~~~bbbb~b~~~b~~~~bb~~b~~~~~~b~~bbb~~~~~~~bbb~~~~~b~~b~~~~b~~~~~~b~~~~~~~~b~
~~~~~~~b~b~b~~b~b~b~~~b~~~~~~~b~~~~b~~~b~~~~~~~~~b~~~~b~~b~~~bbb~~~~~~b~~b~~~~b~b~~~~~b~b~~~~~~b~~b~b
~~~~~~~~b~b~~~~b~b~b~~~~~~b~~~~~~b~~~~b~~~~~~~~~~~b~bb~~b~~~~b~bb~b~~~~~~b~~~~~b~bb~~~~~~b~~~~~~b~~~~
~bb~bb~~~~~~b~~~~~~b~~b~~~bb~~~~bb~bb~~~~~~~~~~~~b~~b~b~~~~~~~bb~~~~~b~bb~~~bb~b~~~~b~b~~~~bb~~b~~~b~
b~~~b~bbb~~~b~b~~~~~b~~~~~b~~~~~b~~~~bbbb~~~~bb~b~b~~b~bb~~b~bb~~~bbb~~b~bb~~~b~~bb~~~~~~~~~bb~~b~b~b
~~bb~~b~~~bbb~~~~~~~~~~b~~~~~~~~~~~~~~b~~~b~~bbb~~~bbb~~~~~~~b~~~b~b~~~bbb~bbb~~~b~~~bbb~~bbbb~b~~b~~
b~b~~~b~~b~~b~~~~~b~~b~~~~b~~b~~~~b~b~~~~~~~bbb~~b~~~~bb~~~bb~~b~~b~~~~b~~b~~~~~~b~b~b~~~~bb~~~b~~~~b
b~b~b~b~~~bbb~bb~~~~~~~~~b~~~~~~bb~~~~~~~~~b~~~~~~~~~~bb~bb~~~b~~b~~bb~bb~~~~~~~~b~bb~b~~~~~b~~~b~b~~
~~~~~~b~~~~~b~b~b~~~~~~~b~~~~bb~~bbbbbb~b~~b~~b~b~~~~~~~b~b~b~b~~~~~~b~~~~~b~~bb~~~~~~~~b~bb~~~~~~~~b
bb~~~~b~~~~~~b~~~~b~~~bb~~~b~~b~~~~~~~~~~bbb~~~~bb~~bb~~~~~b~~bbbb~~~~b~b~b~~b~b~~bb~b~~~~~~~~b~~b~~~
