~b~bb~bbb~b~~~~b~b~b~~~~~~~~b~~~~~~~~bbb~~~~~bb~~~~~b~~~~b~~b~bb~~bbb~~~b~b~~~b~~~~~~b~~~~~b~b~~~bb~~
b~b~~b~~~b~~~b~~~~~b~~~~~bbbbb~b~~b~~~~~~~~~~~~b~~~~~bb~~~~~~b~~~~~~~~~~~b~b~~b~b~~~bb~b~b~b~~~~~~~~~
b~~~~~~~~b~b~bbb~b~~~~~~~~~~b~bb~~~~~~~~bbb~~~~~bbb~b~b~b~~~~~~~~b~~bb~b~~b~~b~b~~~~~~~b~bb~~bb~b~b~~
~~~~~bb~~bbbb~~~~~b~bbb~~~~b~~bb~b~~~~~~~~bb~~~~~~~~b~~~~~b~b~~bb~~~~~~~bbbb~~~~b~~~~~b~b~~bb~~~~~bb~
~bbb~~~bb~~~b~~~~~~b~~~~~~~b~~~~~~~~b~~~~b~b~b~bb~~b~bb~~~~bb~b~~b~~bb~~b~~~b~~~b~b~~~~~~b~b~bbb~b~~~
~~~~~~~b~~~b~~b~b~~~~~~~~~bb~~b~~~~~~~~~~~~~~~b~~bbbb~~~~bbbbb~bbb~~~bb~bb~b~~~~~~b~bb~~b~b~b~~bbb~~~
b~~b~~~~~~b~~b~bbb~~~~~b~~~b~~~~~~b~b~b~~~~~~~~~b~~~bb~~b~b~b~b~~~~b~~bb~b~bb~b~~~b~bbb~~~~bb~~~~~b~~
b~~b~~~~bbb~~~~~~~~~~b~~~~b~~b~~~~~~~~~~~~~~~b~~b~~~~b~b~~b~~~~~~~~b~b~~~~b~bb~~~~~~~~b~b~~~~~~bb~bb~
~b~~bbb~~~~~bb~b~~bbb~~~b~~~~~b~~bbbb~~~~~~~~~~~~~~b~b~b~~~~~~~~~~~~~bbb~~bb~~~~b~b~~~~~bb~bb~b~~~~~~
~~~~~~bb~~b~~~b~b~~bb~~bb~b~b~~~b~b~~b~~~~~~~~~b~b~~b~bbb~~~~~~bbbb~b~~~~b~~~~bb~~~~b~b~~b~~~b~~~b~~~
~~b~~~bb~b~~~~b~b~~b~b~~~b~~~~~~~~~~~~b~~~bbb~~~b~b~~~b~bbb~~~~~b~~~~~~~~~~~~~bb~~~b~~b~b~~b~~~~~b~~~
~~~~~~b~~b~bb~b~~~bb~~~b~b~~~~~~~~~~~~~~b~~~b~b~~b~~~~b~~~~~~~~~~~b~~~~~~~~~~b~~b~~~~~b~b~bbbb~~~bb~b
~~b~~~b~bb~b~~~~b~bb~b~b~~~~~~~b~~~b~~~b~b~~~~~b~~~~~~~~~~~~~~bb~~b~~~~b~~~~~~bb~~b~~~~~~~~b~~~~~~b~~
~~~~~~~~~~~~~~~b~b~b~~b~~b~~bbbb~~~~b~b~b~~~bb~~b~~~~~~~~~~~bbb~~bbS~b~~~~~~~~~~~~~~~~~~bbb~~~~~bb~~~
bb~~~b~~~bb~~~~b~~~~bbbb~~~bb~~~bb~bbb~~b~~b~b~~~bb~~b~b~~~~~bbbb~~b~bb~bb~b~~~~~~bb~~b~~~~bb~~~~b~~~
~~~~~~b~b~b~~~~~~~~b~b~~~~~~~bb~b~b~b~~~~~~bb~b~~~b~~~~~~~~bb~~b~~~~~~~~~~~b~~~~~~~~~~bb~~~~~~~~~b~~~
b~~b~~b~~b~~~bb~~~~~~~bbb~~b~~~b~~~~~bb~~~b~~b~~~~~~~b~b~~~~~b~~~~b~~~b~~~~b~b~~~~~~~~~~~~~b~bb~~b~b~
~~~b~b~~b~~~bb~bb~~~~~~~b~bbb~~~~~~bbb~~~b~~~~~~~b~~~b~bb~bb~~~~b~~b~b~~~~b~~~~~~bb~bb~~~~bb~b~~~~~b~
b~~b~~~b~~~~~bb~b~b~~~~~~b~~~~b~~bb~~~~b~~bbb~~~~~~b~~~bb~~~b~b~~~~bbb~b~~~bb~~~b~~~~~~~b~b~~~~~~b~bb
~b~~~~~~b~b~~~~b~~~b~~~~~b~bb~b~~~bbb~~~~~~~bb~b~~~b~~~b~~b~~~~b~~~~~~~~~~b~b~~~bb~~~b~~bb~~~~~~~b~~~
~~~~b~~~bb~~b~b~b~b~b~~~~~~~bb~~~~b~bb~~~~~~~~bb~b~~bb~~~bb~b~~~~~~~~~~~b~~~b~b~b~~~~b~b~~~~~~bbb~~bb
~bb~~~~~~~~~~~b~~bb~~bb~bbbb~b~~b~~bbbb~~~~~~~~b~~~~~~~bb~~~~~~bb~~~b~bb~~~b~b~~b~~~b~b~~bb~~~b~~b~~~
~~~~~~~~b~~b~~~~~~~b~~b~~~bb~~~b~~~~~~~bb~b~~bb~~~~bb~~~~b~~b~b~~~~~~b~~~~~~~~~~~~~~~~b~~b~~~~~~b~~~~
~~~~b~b~~~~~bbb~~~~~b~b~~~~b~~~bb~~~bb~bb~~~~~~~~b~b~~b~~~~~bbbbb~b~~~~~b~bb~~~~~b~~~~~bbb~~~~~~b~~b~
~~~~~~~~~~~~b~b~b~~b~b~~~~~~b~b~~~~~~~b~~~~~~~~b~~~~~~~~~bb~~~~bb~~~~~~~~~~b~b~~~bb~~~b~~~~~~bbb~bbb~
b~~bbb~~b~~~b~~~~~~b~~~~~~b~~b~~~~~~~b~b~~~b~~b~~~~~~~~~~~~~~b~~~~~~~~~b~b~~bb~~bb~b~b~~~~~~~b~~bb~b~
bb~bb~~~~~~bbb~~bb~~b~b~~~b~~~bbb~b~~~~bbb~bb~b~~~~~~b~~~b~~b~~b~~bb~~~~~~b~~~~b~~~~~~bbb~b~~~~~~~~b~
b~~~~~~b~~~~bbb~~~~~~~~~~bb~~~~bb~b~~~~~b~~b~bb~~b~bbbbb~~b~~~bbbb~~~~~~b~~~b~b~~~~~bbb~~~b~~~~~b~~bb
~~~bb~~bb~~~b~~~b~~~~~~~~~~~bb~~~b~~~~~b~~~b~b~~~~~b~~~~~~~b~~~~~~~~b~~~bb~b~b~~~~~~~~~~~~~~b~bb~b~~~
b~~~b~~~~~b~~~~bbbb~~~b~~~~~~~b~~bb~b~~~b~~b~b~bb~b~~~~~bbb~~~~~~~~b~b~~b~~~b~~~b~bb~~~~~~~~~~~b~bb~b
~~~~~b~~~~~~~~~~~bb~~~b~bb~b~~~~bbb~~~~~~~b~b~~~~~~~b~~bb~b~bbb~b~~~b~~bb~~b~~~~b~b~b~~b~~~~~~~~b~~~~
bb~b~b~bbb~~~~~bb~~~~~~~~b~b~bbb~b~~~b~~b~~~~~bb~~~~b~~~~~~bb~~~bb~~bbb~~b~~~~~~b~~b~~b~~~b~~~~~~~b~~
b~~b~b~~~~~b~~~b~~~~b~~bb~~~~~bb~~~bbb~b~~~~bb~b~~~bb~~~~bbb~~~~~~~b~~~b~~~~~~~~b~~~~~~~~b~b~b~b~b~bb
~~~~~~~~~b~~~b~~bb~bbbb~b~b~~~~b~~~~b~~~bbb~~~~~bbb~b~b~bb~~~bb~b~~~b~~~bb~~b~~~~b~~b~bbbb~~~~~bb~b~~
bb~~~~~~b~bbb~b~bbbb~~~~~~~~bbb~b~~bb~~~~~b~~~b~~~~~~~~~~~~b~~~b~~~b~~~b~~~bbb~~~~b~~~~b~bb~bbb~~~~~b
b~~bb~~b~~b~b~b~b~~~b~~~bb~~~~b~~~b~~~~~~~~~~~~~bb~~b~bb~b~~b~~~bb~b~~~b~~b~~~~~~~b~b~b~~~~~~~b~~~~~~
~~b~~~b~b~b~~b~~~~~~~~~~~~~~~~bb~~~~b~~~~~~~b~~~~bb~b~~~b~~~b~~~~b~~~~b~~~~~~~~~~bb~~b~~~~~~b~~b~b~~~
b~~~bb~~~~b~bb~bb~~~~b~~~~~bb~b~b~b~~b~~~bb~b~~~~~~~~~~b~~~~b~~~~~b~b~~~~~~~~~~~b~~~~~b~~~~~~~~~~~~~~
~~~b~~bb~b~b~~~bb~~b~b~~~~~~~b~~bb~b~~~b~~~~b~bb~bbb~~~~bb~~~~~~~~~~~~b~~bbb~~~~~~b~~~~b~bb~~b~b~~b~~
b~b~~b~~~~~b~~~b~~~~~~~b~b~b~b~~bb~~~~~~~~~~bbb~b~~b~bb~~~~~~~~~~~b~~~~~~~~b~~~~~bb~b~~~~b~~~~~~~~~~~
~bb~~~~b~b~~b~b~~b~~~~~~~b~~~~~~~b~~~~b~~~~~~~~~~~bb~~b~bb~~~~~~b~~b~b~~~~b~~~b~~b~~~b~b~b~~b~~~~bbbb
b~b~b~~~~~~b~~b~~bb~b~~~~b~~b~~~~bb~~b~~~b~b~~~bb~b~bb~~~~bbb~bb~~b~~~b~bbb~~~bb~~~b~~~bb~~b~~~~~~b~~
~~~b~~~~~~~~~b~~~~b~~bb~~~b~b~b~~~~~~b~~~b~b~~~b~~~~~~bb~~~~~~~b~~~b~b~~~~~~~bb~bb~b~~b~b~~~~~~~~bb~~
~bb~~~b~~~~~~bb~~bb~~b~bbb~~~~~~~~~~~b~~bb~~~~~~~~~~~~~~~~~~bbb~~bb~~b~~~~b~~~~b~b~~~b~bb~~~~b~b~~~~~
b~~~bb~~b~b~b~~~bbb~~~~~~~b~~~bbbbbbbb~b~~~~~~b~~b~~b~~b~bbb~~~~~~~b~~~bbb~b~~~~~bb~~~~~bb~~~~b~b~~~~
~~bb~~b~~~~~b~~b~~~b~~~b~~~bb~~~~bbb~~b~~~~b~~~bb~~bbb~~~~~~~~b~b~~bb~~~~~~~b~b~bbb~~b~~~b~~~~~~~~~~~
b~~~~~~bb~~~~~~bb~~b~~~~~b~b~~~b~b~~~~~~~bbb~~b~~~~~bb~~~b~~~bb~b~~b~b~~~~~~~~~~~~~~~~b~~~~~~~~~b~~~~
~~~~~b~b~~~b~~~~~~~~b~~~~b~~~~b~~b~~~~b~bbb~~~b~b~~bbbb~~~bb~~b~b~~~~bb~~b~bb~bb~~~~~~~~~~~~b~~~b~~b~
~~~b~~~~~~b~~~b~~~~~~~~bb~~~~~~b~~b~~~~b~~~~b~~~~b~~~~~~~~~~~~~~~~b~~~~~~b~~~~bbb~~bbbb~~~b~~~~b~~~~b
~b~~~~~~b~~b~~~~~~~b~bbb~~~~~~~~b~~~~~~~~~~b~bb~~~b~~~~~b~~~~~b~~b~~~~~b~~~bb~bbb~b~b~~b~~~b~~bb~~~bb
~~~~~~~~b~~~~bb~~~bbb~~bb~~~~~~b~b~~~~~b~~~~b~~~~~~~~~~~~b~~~b~bb~b~~~b~~~b~~bb~~~b~~~~bb~bbb~~~~~~b~
b~b~~bb~b~b~~bb~b~~b~~bb~~~~~b~~~b~b~~~~b~~~~~b~~b~~~b~~~~~~b~b~~~bb~~~~b~~~b~~~bb~b~b~~b~bb~b~b~b~~~
~~~~~~~~~~b~~~~~~~b~bbb~~b~~bbbb~~~b~~~~~~~~~~~~b~~~~~~~~~~bb~b~b~b~~~~~~~~~b~~~~~bb~~~~~b~~~bb~b~b~b
~bb~~~b~~b~~bb~~~~b~b~~~~~~~~~b~~~~~~b~~b~~~b~~b~b~bbb~~~b~~~b~~~~~~~~~b~~~~~~b~~b~b~b~~~~~~~~b~~~~~~
~b~~~bb~~b~~bb~bb~~~b~b~b~~~~~~~~b~~~~~b~b~~bb~b~b~b~~bb~b~~b~~~bb~b~bb~~bb~b~~~b~~~b~~~~~~~b~~~b~b~~
~~~b~~~b~b~~~~~~~~~~bb~~~~b~~~~~~~~~b~~~~~b~~b~~~~bb~b~~~~~b~~~~~bb~b~~~~~bbb~~b~~~~~b~~bb~b~~~~~~bb~
b~~~~~~~~~~~~bb~~~~~b~bb~b~~bbb~~b~~~~~~~~~b~~~bbb~~b~bb~~~b~~~~~~~~b~~b~b~~~~~b~~b~~~~~~~~b~b~~~~bb~
~~~~~~~~bb~~~bbbb~~~~b~b~~~~~~b~~~~~bb~b~~~b~bb~~~b~~~~bb~~~b~b~b~~~~~~~~~b~~b~b~~~bbbb~~~~~~b~b~b~~b
~b~~~b~b~~~b~~b~~~~~~~~~~~~~b~~~~~b~~~~~~~~b~~bbb~~bb~~~b~b~~~b~~~~bb~~~~~b~~~b~~b~~~bb~bb~~bb~~~~~b~
~b~~~~~~bb~~~~~~~~b~~b~~~~~b~~~~~b~~~~~~~~b~~~~~~~~~~bb~~bb~~b~b~~~~~~b~~~~~b~~b~b~~~~bb~b~~~~~~~~bb~
b~bbb~~~~~~~b~~~~~b~~~~~~~~b~~bb~b~~b~~b~~b~~~~~bb~~~~b~~~~~~b~~b~~~bb~~~~~~~~~bb~~~b~~~b~b~~~~~~~~b~
~~~~~bb~~~bbbb~b~~b~bb~~b~~~~~~b~b~~b~~bb~~b~~~b~~~~~bb~~~b~~~b~~~~b~b~~~~~bb~~b~~~~~b~bbb~~~~~~~~~~b
~~~~b~~bb~~~~~~~~~b~~~~~~~~~~~b~b~bb~~~~~~~~~bb~~~~b~bb~~~b~b~~~~~~b~~~~b~~~~b~~~bb~b~b~~bbbbbbb~~b~~
b~~~b~~~~b~~~~~~~~b~~b~~~b~bb~~~~~b~~~~bb~~~~~~~bb~~~~~~~~~~~~b~~~~~~~~b~~b~~~~~b~b~~~~~~b~~~~b~~bb~~
~~~b~~~bb~~b~~~~~~bb~~~b~~~~~~~~b~~b~b~~~~~~~b~~~b~~~~~~~bb~~~b~~~~~b~b~b~~~~~b~~b~~~~b~~b~~b~~~b~~b~
b~~bb~b~~~b~~~b~~~bb~bbb~~~~b~b~~~~b~~b~~~b~~~~~b~b~~~~~~~bb~~~~bb~~~bbbb~~~~~~~~~~~~~bb~~bb~~~~~~b~b
~~~b~bb~~~bb~~~~b~~~~~b~~~~~~b~~~bb~~~~b~~~~~~~~b~~b~~~~~b~~bb~b~~~~~b~b~~b~~b~~~~~~~~b~b~~~~b~~~~~bb
bb~~~~bb~~b~~b~~b~~~~b~~~bbbbb~b~~~~~~~~~~~~~~b~~bbbbb~~~~bb~~~~~~~~~~bb~~~~~bb~~~b~~b~~~~~~b~b~~~~~~
~~~~~b~b~b~~bb~~b~~~bbb~b~~~~~b~b~~~~b~~b~~~b~~~~~~~b~~~b~b~b~b~~b~~bb~~~~~~~bbb~b~~~~~~b~~~bbbb~~b~~
~~~~~~b~bb~~~~bb~~~b~bb~bbbb~~~~~b~~b~~~b~~~~~bbb~~~b~bbb~b~~bb~~bb~~~~b~~~~~~bb~~b~~~b~b~b~~~~~b~b~b
~~~~~b~b~b~~~b~b~~~bb~~b~~b~~~b~~~~~~b~~~~~~~~b~~bb~~~~~~b~b~~~~~b~~~~~b~b~b~~~~~~bb~~~~~~~~~b~~~~~b~
~~b~b~~~~~~~~~~bb~b~~~bb~b~~~~bb~~~~~~bb~~~~~~~bb~~bbb~~~b~b~~~~~~~bb~~bbbb~~~~~~~~b~~b~b~~~~~~b~b~~b
b~~~b~~~b~~b~~~b~b~~~~~~~b~~~b~~b~~bb~~~~bb~~~~bb~b~~~~~~b~bb~~bbb~b~~~~b~bb~~b~~~~b~bb~~~b~~~~b~~bbb
~~~~~b~~~~~~~~bb~~~~b~~~~~~~~~~b~bb~~b~~~~~~~~~bb~b~~~~~~~b~~b~~~b~~~~b~~~~b~~~~~~~b~b~b~~bb~~bbbbb~~
~b~~~b~~~b~~~bbb~bb~b~~~~b~b~b~~~~~bb~~~~~~bb~~~b~~~~b~~~b~~b~~b~~~~b~~~b~~~b~~~~b~b~~bb~~~~b~~b~~~b~
b~b~~~~b~b~b~~bb~~~~b~~~~~~~b~~~bb~~~bb~~~~bb~~b~~~~~~bb~~b~~bb~~~b~bb~~~b~~~~~~b~b~~~bbbb~~b~~b~bb~~
~~~~~bb~~~bb~~b~~~~~~~~~~bbb~b~~bb~~b~~~b~bb~~~bb~~b~~b~b~~b~~b~~b~~~~~~~b~b~~~~~b~~~bb~~~~~~bbb~~~~b
b~b~~~~~~b~~~~~b~~~~~~~~~~~~~b~~~~b~b~b~~bbbb~~~~~~b~~~~b~~b~~~~~~~~~b~~b~~b~~~~~~~~~b~~b~~b~~~b~~~~~
~~~~~~~~~~b~b~~~~b~~~~b~bb~bbb~bbb~b~~~~~~b~bbb~~~~~~bb~~~~bb~~bb~~~b~bb~~~~~~~~~~~~~~~~~b~~~~~b~~bb~
bbb~~~b~~~~b~b~~~~b~~~~~~bb~~~bbb~~~~~~~bbbb~~b~~~b~b~~~~~~~~~~~bb~~~~b~~~b~b~~b~~b~~~~~~b~~~b~b~~~~~
~bbb~b~b~~~~b~~~~~~b~~~~b~~~~bb~~~~bb~~b~b~~~~~~~~b~bb~~b~~b~b~~~~b~b~bb~~~~~~~~~~bb~~b~~b~~~~~b~~b~~
b~~~~~~~~~b~~~b~~~~bb~b~~~~~~~b~b~b~~b~~b~~~~~~~b~bb~b~~~~~~b~~~~~~~b~~~b~~~b~~~~~b~~~~~~~~~~~~b~~~~~
bbb~~~~b~~~~b~b~~bb~~~b~~b~bb~~~~~~~~~~~~b~~~~b~~b~~~~~~~bb~~~~~~~b~~~~b~b~~~~~~~~~~~~~~~bbb~~~~~~~~~
b~~~b~~b~~~b~bbb~~b~~~~b~~b~~~b~~~bb~~bb~~~~~b~~~~b~~~~~b~~b~~~~~~~b~~bb~~~~~bb~~b~~~~~bb~~~~~b~bb~bb
~~b~~~b~~b~~~b~~~~bb~~~~~~~~~b~~bbb~~~bbb~~b~~b~b~~~bbbb~bb~~~~b~b~bbb~~bb~~~~~~~~~b~b~~~~~~bb~~bb~~~
bb~~~~~~~~~~~~~~bb~b~~~~bb~~b~~~~b~~b~b~~~b~~~~~b~~~~b~~~~~~~~bb~~~~~~bb~b~~~~~~~~~~~~~~bb~~~~~~~~~~b
bb~~~b~~~~~b~~~~~b~~bb~~bbb~~~~b~~b~b~~~~~bb~~~~~~~bb~~~bb~bbbb~~~~~~~~~~~~b~~~~~~~~~~~~bb~~~~~~bb~~~
~bb~bb~b~~b~~bb~~~bb~~~bbb~~b~~~~~~~~~bbb~~b~bb~b~~~~b~~~~~~~b~~~~~~~b~~~~~b~~~~~~~b~~~~bb~~~~~~~~~~~
~bb~~~~b~b~~~~~~~~~~~~~~~~bb~~~~~~~~~~~~~bb~bbbbbbb~~~~b~~b~~~~bb~b~bb~b~~~~~b~~~~~b~~b~~~~b~~~b~~bb~
~~~b~b~b~b~~~~~b~~~~~b~~b~~bb~~b~~~~b~~~b~~~~~~~~~~b~b~b~~~~~~b~b~~~b~~~~~~~~b~~~b~b~~b~~b~~b~~~~~bb~
b~~~b~~b~bb~~~~~b~~~~~~~~b~b~~~b~~~~~~~~~~b~~~b~~bb~b~~~~b~~~~~~~~b~~~bb~~~b~~~bb~~~~~~bb~~~~b~~~~~~b
~~~~~~~b~~b~b~b~~~bbbb~~b~~~~~~~~~b~~b~~~b~b~~bb~~b~~~~bb~~~bb~~~~~~~~~~~b~b~b~~~bbb~b~b~~~~b~~~b~b~b
~b~b~~b~bb~bb~~~~~~~~b~~~~b~~bb~b~bb~~b~~~~bb~~~b~~~~~~bb~~~~bb~~~~~~~~~~~~~~~~~b~~b~~~~~b~~bb~~~~bb~
b~~~b~~~~~~~~bbb~~~b~b~~b~~~~~~~b~b~b~~~~~b~~~b~~~~~~b~~~b~~b~~bbb~~~~~~~~~~~~~~~~~~b~b~~~b~~~~~bb~~~
b~~~bbb~~~b~~bb~~~~~~~~~bb~~~b~~~~~~~bb~b~bb~~~~b~~~b~~~~~~~~b~~b~bb~bb~bbb~bb~~bb~Gb~~~~b~~~~b~~b~~~
~~bbbbb~~~~~b~~~~b~~~b~~b~~b~~~bb~~~~~~b~~~b~~~~~b~~~~~b~~~bb~bbb~~~b~~~b~bb~~~~~~~~b~~~b~b~~b~~~~b~~
~~~~~~~~~~b~~~~~bbb~~~b~~~~~~~b~~~~bbb~b~~~~b~b~~~~~~~~~~~b~~~b~~~b~b~~b~~b~~~b~b~~~b~~bbb~~~b~~~~b~b
bb~~~~~b~~~~~bbbbb~~~bb~~~~b~bb~~b~~~~~~~~~~bbb~~~~~~~~~~~b~~b~b~~~b~~~b~~~b~~~b~~~~~bb~~~~~~b~~~~b~~
~bbb~~~~b~b~b~~bb~~bbb~~~bb~~bb~b~b~~~~~~~~~~b~~~bb~~~~bbbb~~~~~~~b~b~~b~b~b~b~bb~b~bb~b~~b~~~b~~~~~~
b~b~~~~~~~~~~bbbbbb~bbbb~~b~~~b~bb~~~b~b~b~~~b~b~b~~~~~~~~b~~~~~~~~~b~~~~~~b~~~~b~~b~b~~~b~bb~~~~~b~~
~~~~~b~bb~~~~b~b~b~~~~b~~b~b~~~~~~~~~~~~~~bb~~~~~b~~bb~~~bbbb~~~~~~b~b~b~~~~b~~~bbb~~~b~bb~~b~~~~~~~b
